"date","abnormalities","acs.student.loan","against.healthcare.reform","american.oil","amtrak.promotional.code","annual.earnings","annual.inflation.rate","annual.inflation","anonymous.com","anthropology.com","arts.and.craft.store","asset","athlete.black.swan","atlantic.city.coupons","balance.sheets","bank.of.america.government.credit.card","beautiful.places.to.visit","best.lunch.spots","bpa.safe","burger.places","businesses","calculating","california.housing","care.bill","care.legislation","care.news","cars.under.10k","cbcweb","certificates.of.deposit","chat.family","cheap.san","cheap.used","cheap","chesapeake.oil","chicago.bar.and.grill","chicago.to.nashville","civic.reviews","coldwater.creek.catalog","cost.of.rice","counsel","cpi","ct.unit","current.health.care.reform","dairy.cattle","delaware.tech","dell.support.com","determining","diesel.conversion","diesel.fuel.mileage","diesel.mileage","dynamics","early.pregnancy.tests","education.foundation","educational.video","educations","equity.lines","estate.rentals","estimating","family.chat","family.homes.for.sale","family.income","fashion.industry","federal.union","fico.scores","figaros.pizza","filter.systems","financial.statement","finder","food.crises","food.crisis","food.inflation","food.price.increases","food.price","food.prices","food.shortage","food.vs.fuel","for.rent.craigslist","free.music.download.program","fuel.cards","gas.card","gas.cards","gas.credit.card","gas.credit.cards","gas.credit","gas.economy","ge.commercial.finance","global.food.shortage","global.food","government.run.programs","graingers","grants.and.scholarships","greenberg.dental","ground.check","growth.rates","hc.bill","health.bill","health.care.bill.pdf","health.care.bill.text","health.care.bill","health.care.cartoon","health.care.legislation","health.care.plan","health.care.poll","health.care.polls","health.care.reform.explained","health.care.reform.poll","health.care","health.insurance.bill","health.policy","health.reform.bill","health_care","high.food.prices","high.school.education","hines.com","hometrends","honda.civic.reviews","hospitality.jobs","hotel.coupons","housing.price","housing.prices","how.far.is.greenville","how.far.is.lexington","how.to.make.biodiesel","hydrogen.electrolysis","icard","ignite.gas","illnesses","income.levels","income.statements","incomes","increase.in.food.prices","inflation.rate","insurance.reform","intercontinental.hotel.group","jackson.state.bank","jobs.in.oregon","jobs.in.south.carolina","kaiser.employment","kaiser.com","lasalle.online","latin.america","law.program","lawrence.kansas","lincoln.state.bank","long.pixie","make.biodiesel","making.biodiesel","map.of.us","marketing","marta.transit","median.home.prices","median.price","medical.treatments","mi.to","michaels.arts.and.craft","minnesota.council.of.nonprofits","miscarriages","money.for.college","money.make.me.come","movies.go.com","natural.resource","navy.fed.credit.union","navy.fed.credit","new.health.plan","newport.news.fashion","news.fashion","news.health.care","north.dakota.real.estate","not.for.profit","nursing.education","oil.imports","oklahoma.city.jobs","opticians","orlando.discounts","parts.per.million","pilot.gas.stations","pizza.hut.pasta","places.downtown","planned.parenthood.chicago","poems.and.quotes","poll.health.care","polls.health.care","pregnancy.by.week","price.index","proactiv.com","proactiv","proactive.com","qpublic","rate.of.inflation","rate.","real.estate.price","really.cheap","rear.delt","recycle.number","rent.craigslist","rent.to.own.sheds","rental.car.rates","rental.rates","rentals.in.north.carolina","resort.specials","rising.cost.of.food","rising.food.prices","safeco.com","sale.st","sallys.beauty.supplies","shell.gas.stations","social.service.jobs","soils","southwestern.grill","spot.market","stop.credit.card.offers","suv.mileage","term.labor","texas.jobs","texas.state.bank","text.of.health.care.bill","time.zones.in.us","training.in","tx.employment","united.states.gdp","universal.health.care.bill","us.food.prices","us.health.care.bill","us.health.care.reform","us.health.care","us.health.reform","us.health","us.healthcare.bill","us.inflation.rate","us.inflation","us.oil.imports","ut.southwestern.medical.center","utah.jobs","wall.street.journal.health.care","wasabi.bistro","waste.vegetable.oil","wedding.templates","what.is.health.care.reform","why.health.care.reform","wind.power.for.homes","world.food.prices","xpe","zillow.","zillow","zios.italian"
"2004-01-01",74,61,0,51,0,55,81,42,53,29,55,98,0,21,84,0,0,10,0,2,100,86,81,"<1",26,18,0,0,68,66,55,75,86,0,50,0,41,73,0,89,93,9,0,90,93,94,91,31,16,17,83,57,100,67,82,72,77,93,66,17,54,83,58,43,0,55,77,93,0,4,16,0,41,43,6,0,"1",69,36,33,24,40,29,40,20,27,0,32,0,68,47,10,69,61,0,1,"0","0","<1",0,12,16,"3","0",0,"9",28,2,100,"0",24,0,92,0,16,41,81,49,71,61,0,0,"9",27,36,0,93,80,24,58,0,63,7,55,20,72,68,53,100,12,83,100,72,36,0,8,25,70,94,49,37,65,58,5,63,100,69,45,0,46,77,42,49,44,55,74,8,26,71,84,27,79,100,65,69,31,6,7,50,75,"3","0",28,90,61,55,50,0,58,78,65,62,7,13,1,0,55,74,41,66,0,0,25,14,32,58,70,76,19,50,69,21,57,65,55,"0",18,85,51,100,18,35,"0","0",26,5,65,"0",77,70,30,41,65,0,58,40,43,"2","0",0,26,81,0,"0",42
"2004-02-01",91,57,0,46,36,92,67,100,51,38,64,100,0,30,72,32,18,0,0,2,98,96,94,"1",26,21,19,39,67,59,46,76,84,54,28,0,29,36,30,86,98,22,0,88,69,0,93,52,16,21,83,56,87,75,82,71,88,83,59,11,100,82,54,61,40,74,87,92,97,18,15,0,32,46,9,0,"<1",62,18,28,21,54,36,38,27,34,0,37,0,57,50,9,47,100,21,1,"0","0","<1",30,6,16,"0","0",0,"0",28,0,99,"<1",14,0,79,0,16,33,69,38,49,53,0,0,"18",20,53,0,100,69,29,73,0,89,6,27,38,58,49,82,32,18,100,74,75,36,11,28,37,72,100,16,46,46,64,6,51,57,58,34,0,36,100,52,48,8,80,81,9,45,93,88,16,46,98,39,60,30,6,7,31,74,"0","0",31,100,0,48,39,6,77,83,78,92,7,19,1,0,84,71,48,50,0,0,25,14,41,48,96,82,19,49,67,17,40,59,41,"0",36,81,24,53,0,34,"0","0",24,0,80,"0",100,84,25,100,48,44,38,38,28,"0","5",0,26,58,0,"0",0
"2004-03-01",97,43,0,60,0,97,100,31,65,48,27,88,0,51,78,81,0,0,0,3,96,90,94,"<1",24,19,24,0,61,37,60,84,82,46,26,16,47,60,39,88,81,11,0,61,82,59,91,50,20,31,100,44,87,74,87,63,80,100,37,16,59,87,55,42,100,100,93,88,0,9,0,0,21,48,9,0,"1",42,77,31,19,47,21,38,23,34,0,43,0,72,57,12,26,73,0,1,"0","0","<1",38,15,14,"0","0",0,"0",27,3,83,"0",35,0,100,70,51,60,63,50,76,47,0,15,"12",59,72,75,93,99,50,95,0,66,7,51,24,54,44,75,41,46,93,92,77,0,0,20,23,74,91,41,39,40,80,10,52,41,94,49,0,23,82,92,48,27,17,100,7,97,93,81,45,54,97,62,71,0,0,6,55,0,"0","0",28,84,37,47,25,7,57,60,78,55,0,0,1,0,53,63,35,75,0,0,63,14,39,28,77,82,35,30,86,31,30,54,44,"0",79,84,31,57,0,88,"4","0",23,0,62,"0",95,84,37,50,58,56,24,25,40,"0","0",0,33,60,0,"0",0
"2004-04-01",79,36,0,56,47,67,26,32,99,55,93,95,0,58,45,31,34,10,0,2,97,100,86,"1",31,20,18,0,44,62,62,72,81,0,53,0,47,69,30,82,92,0,0,70,38,45,100,59,30,26,85,34,90,78,100,59,81,85,62,16,67,77,55,54,0,79,100,90,0,5,37,94,35,44,6,0,"1",11,17,33,22,38,33,42,42,59,0,33,0,38,49,9,40,80,0,1,"0","0","<1",29,23,15,"3","0",0,"0",28,3,100,"0",27,31,86,54,62,35,58,56,63,48,0,12,"0",78,68,29,81,57,41,59,0,100,7,51,18,50,56,72,0,12,94,66,82,35,10,0,12,80,96,47,35,74,96,8,59,71,57,56,0,17,84,0,28,18,0,72,5,87,100,73,48,39,75,43,54,29,0,5,54,0,"3","0",32,97,72,43,38,0,94,90,65,97,13,18,1,0,67,67,62,38,0,0,24,17,60,55,100,100,36,47,0,29,85,52,52,"0",52,78,39,87,0,84,"3","5",24,0,67,"0",93,63,62,39,43,0,37,28,29,"0","0",0,37,82,0,"0",100
"2004-05-01",80,45,0,69,53,75,12,22,91,50,56,90,0,80,36,42,0,0,0,0,87,80,90,"<1",6,16,0,0,48,52,69,82,88,24,12,11,48,83,27,84,88,8,0,60,80,41,83,78,55,58,81,73,75,58,79,62,87,86,52,16,48,72,54,52,17,72,81,97,0,8,20,0,34,60,10,0,"1",39,100,48,40,69,39,67,47,41,0,35,0,56,31,8,50,66,0,1,"0","0","<1",26,13,10,"0","0",0,"0",26,1,91,"<1",8,57,79,0,71,64,52,55,63,64,0,0,"0",94,46,0,78,69,42,64,0,72,3,24,34,83,69,72,100,37,90,80,80,63,0,18,38,73,87,100,45,52,55,8,27,65,69,55,0,47,99,55,34,21,47,72,3,62,61,77,61,40,77,56,63,26,0,8,76,0,"0","0",34,79,65,46,52,0,85,90,73,88,0,0,1,20,58,71,39,70,0,15,55,14,18,46,81,67,33,32,59,38,77,65,47,"0",24,74,30,74,0,61,"3","0",20,0,63,"0",40,68,78,35,61,19,42,43,36,"0","0",0,57,94,0,"0",36
"2004-06-01",84,67,17,78,0,28,24,15,0,42,38,100,0,27,51,43,16,0,0,4,93,76,92,"1",12,20,0,0,71,40,78,78,98,16,50,11,57,75,0,100,94,8,0,68,78,0,83,63,21,51,76,81,99,66,68,100,87,76,40,25,67,76,60,65,36,66,90,100,0,5,14,87,31,27,3,0,"1",70,79,41,26,50,23,37,29,42,0,24,0,60,42,17,47,67,0,1,"0","0","<1",0,5,17,"4","0",0,"0",28,6,83,"0",25,0,69,100,50,62,86,77,79,74,0,0,"0",48,59,0,67,71,31,39,0,68,10,72,34,78,86,80,0,11,60,58,85,32,10,22,11,69,94,58,65,67,25,11,0,22,74,44,0,73,61,19,34,36,24,69,8,40,90,82,46,68,96,58,68,0,5,8,100,0,"4","2",31,85,67,54,53,5,37,73,68,83,12,0,1,0,75,74,86,71,0,0,45,15,37,67,86,49,50,44,30,34,79,78,71,"0",40,77,56,45,0,62,"0","0",12,4,57,"0",83,62,22,18,80,20,34,0,62,"0","0",0,0,95,0,"0",0
"2004-07-01",68,64,0,49,45,43,49,8,48,18,80,92,0,75,58,60,16,0,0,2,93,82,98,"1",12,16,0,37,89,32,76,93,99,17,45,18,62,77,28,81,95,16,0,67,53,43,80,62,22,23,77,78,71,44,58,66,100,67,32,13,49,81,62,68,0,79,71,100,0,7,0,0,28,19,3,0,"1",47,65,49,43,45,57,38,18,38,0,46,0,76,35,9,48,56,0,1,"0","0","<1",28,11,16,"5","2",0,"0",26,4,71,"0",9,0,56,52,30,37,100,57,92,62,0,0,"9",63,41,0,71,64,44,72,0,78,8,62,18,61,73,55,0,11,41,75,84,50,10,15,23,71,92,30,100,69,52,9,38,76,67,65,0,75,57,19,27,15,75,59,7,48,88,100,35,50,80,55,52,56,0,10,46,69,"5","2",35,81,83,72,37,0,44,100,84,70,0,12,1,0,100,100,78,88,0,0,69,16,77,70,100,66,17,45,0,23,52,74,52,"0",25,82,50,76,0,0,"3","0",18,5,51,"0",58,46,23,56,56,51,26,36,51,"0","0",0,0,64,0,"0",38
"2004-08-01",72,65,0,80,30,26,22,21,43,48,54,94,0,34,35,27,0,0,11,3,91,67,84,"1",32,19,0,33,93,100,63,100,94,31,70,21,24,90,26,93,91,15,0,44,73,0,85,46,52,37,74,52,74,49,71,67,89,79,100,19,41,51,62,56,33,59,66,98,0,3,26,0,21,23,7,0,"1",61,37,49,27,54,38,45,24,45,0,25,0,63,45,16,48,78,0,1,"0","0","<1",0,10,15,"2","0",0,"0",27,3,87,"0",35,0,64,46,47,37,72,55,81,69,0,0,"8",51,48,0,69,74,22,65,0,53,4,79,48,67,61,100,27,10,46,99,90,59,0,17,15,67,88,27,77,68,53,11,26,55,90,56,0,15,54,35,56,33,56,41,7,59,66,90,55,43,70,66,64,0,0,4,52,0,"2","0",36,79,0,58,58,5,60,67,80,59,6,16,1,0,81,82,81,67,0,0,21,16,69,100,90,62,39,50,28,25,40,69,72,"0",30,77,42,40,0,0,"0","0",19,4,54,"0",32,42,50,66,59,28,64,24,42,"0","0",0,0,94,0,"0",69
"2004-09-01",80,38,0,57,28,36,52,20,61,52,34,87,0,32,69,76,0,8,0,2,95,94,75,"1",15,20,0,31,78,20,56,78,83,29,22,10,30,56,24,87,90,7,0,73,58,0,89,77,49,21,83,44,87,80,63,56,70,88,20,10,61,100,59,66,31,65,92,95,0,9,12,0,23,21,2,0,"1",35,21,33,23,48,26,41,16,11,0,54,0,48,28,15,49,61,0,1,"0","0","<1",0,19,16,"6","4",0,"0",29,3,97,"<1",18,25,88,44,51,26,72,28,66,49,0,0,"7",42,38,23,76,70,36,69,0,72,6,42,23,62,55,53,90,33,77,74,79,85,9,13,19,100,88,64,57,70,100,9,16,45,75,53,0,28,81,33,23,25,63,92,7,76,99,95,41,66,74,51,54,24,4,4,44,0,"6","4",33,85,47,62,16,0,56,75,63,79,10,10,1,0,69,71,63,20,0,0,20,13,41,77,39,70,15,29,53,30,82,66,63,"0",28,75,40,64,0,27,"3","5",26,8,67,"0",69,70,19,94,76,0,30,23,31,"0","0",0,0,75,0,"0",33
"2004-10-01",85,81,0,71,29,62,32,13,62,61,52,88,0,24,100,52,14,0,0,3,88,100,64,"1",31,17,0,32,62,48,50,53,82,15,51,10,42,57,0,79,87,7,0,100,70,75,92,47,38,32,79,67,78,86,76,56,57,87,48,18,55,68,54,61,16,66,89,88,0,6,25,0,30,38,5,0,"1",68,57,38,26,33,27,39,22,43,0,28,82,73,42,8,38,93,0,1,"0","0","<1",48,10,20,"2","2",0,"0",31,4,98,"<1",26,26,77,0,39,27,61,43,76,47,0,0,"30",54,42,0,77,79,41,86,0,68,5,43,31,36,68,42,52,24,87,91,76,72,0,13,10,76,87,53,62,55,28,14,58,40,99,48,0,51,80,17,31,17,21,79,8,47,68,84,69,35,72,56,100,0,5,8,30,0,"2","2",35,84,48,80,40,5,53,92,55,63,21,20,1,19,48,56,45,32,0,0,60,12,33,60,59,82,15,19,0,24,45,50,56,"0",22,75,46,81,14,28,"0","0",24,8,67,"0",64,73,64,80,54,27,38,31,23,"2","0",0,41,99,0,"0",67
"2004-11-01",93,58,0,67,100,97,22,49,43,32,54,92,0,42,74,81,0,0,0,2,90,91,82,"1",16,23,0,0,52,67,55,65,79,23,41,0,34,100,0,91,89,22,0,74,55,39,99,36,20,29,77,64,77,65,71,77,58,85,67,19,72,73,56,71,25,60,94,90,83,12,0,0,39,41,5,0,"2",47,29,52,25,59,47,34,27,23,0,43,86,92,27,0,31,72,0,1,"0","0","<1",0,10,18,"0","2",0,"0",28,3,76,"<1",23,27,68,46,54,31,72,27,70,62,0,0,"8",90,48,76,96,100,51,100,74,81,7,79,32,53,49,44,54,35,95,81,72,0,0,17,10,84,87,0,52,67,53,16,52,55,82,77,22,45,80,44,24,18,11,67,5,70,76,81,57,38,84,62,74,25,5,9,47,63,"0","2",36,74,62,80,50,0,80,67,73,82,6,11,2,0,23,48,27,67,0,0,21,14,26,70,61,81,39,61,71,22,67,43,55,"0",45,73,33,82,0,0,"0","5",27,4,60,"0",67,100,71,17,43,19,32,41,22,"0","0",0,44,89,0,"0",35
"2004-12-01",88,42,0,58,35,80,29,18,0,56,72,83,0,30,38,72,13,15,0,4,76,74,70,"<1",24,20,0,29,75,41,52,49,80,27,36,9,21,35,23,74,80,10,11,36,58,35,74,18,35,17,71,51,52,81,73,7,51,73,41,8,72,63,58,44,22,44,74,98,0,7,23,0,32,25,5,0,"1",42,33,60,42,50,35,32,18,35,0,18,0,63,31,14,66,56,0,1,"0","0","<1",22,7,12,"0","2",0,"0",23,3,79,"<1",10,0,64,0,66,22,50,33,80,58,0,0,"0",50,68,22,75,44,31,54,0,68,3,50,28,54,49,39,60,40,77,77,72,53,8,15,9,60,75,36,46,60,31,9,61,36,71,48,0,67,66,39,64,28,40,71,5,43,70,70,33,42,74,51,53,45,4,5,18,56,"0","2",33,80,77,71,95,0,57,68,70,63,0,14,1,0,53,51,18,63,0,0,55,13,77,72,57,76,34,36,50,17,53,46,61,"0",26,59,31,64,0,0,"0","0",13,4,48,"0",46,85,18,59,49,16,49,43,21,"0","0",0,19,71,0,"<1",92
"2005-01-01",79,58,0,39,31,76,52,33,34,43,28,93,0,40,54,63,12,0,0,0,93,79,74,"<1",21,16,0,26,99,46,57,84,90,30,59,0,30,47,40,97,90,9,9,76,74,0,84,40,36,21,74,50,82,73,74,40,78,78,46,24,65,78,58,59,13,59,74,93,0,7,20,0,31,30,3,0,"1",55,34,36,35,35,35,37,21,35,0,42,0,71,43,9,75,57,0,1,"0","0","<1",0,12,12,"2","2",0,"0",26,3,82,"0",27,0,79,36,63,29,67,51,65,69,0,8,"6",53,37,19,79,45,24,71,0,60,9,18,100,61,72,54,53,8,76,76,84,47,7,16,8,75,87,21,84,53,69,11,34,48,72,68,17,24,83,48,50,33,44,81,5,59,87,90,29,44,74,39,66,20,4,5,49,49,"2","2",36,89,97,76,58,4,62,64,71,59,9,8,1,0,49,57,66,59,0,0,49,15,54,40,63,62,37,16,22,17,57,59,70,"0",65,84,66,53,0,23,"0","0",20,0,53,"0",66,64,23,65,50,14,31,13,36,"1","3",24,34,87,0,"<1",54
"2005-02-01",96,60,0,57,25,75,9,17,72,86,60,98,0,49,61,45,0,0,0,1,84,100,79,"<1",27,17,0,0,55,62,57,63,86,38,78,9,36,42,64,86,93,18,0,78,70,0,96,66,38,13,74,54,84,87,64,42,74,83,62,24,90,83,57,84,28,47,92,91,69,4,0,0,28,40,3,0,"1",51,18,33,30,51,33,39,20,47,0,39,0,55,39,13,69,68,0,1,"0","1","<1",21,13,10,"2","0",0,"0",27,2,88,"<1",20,0,77,78,62,20,70,47,77,83,0,8,"19",37,80,0,85,97,43,65,0,78,6,66,33,57,71,62,46,34,90,82,92,100,8,26,13,71,89,45,54,74,74,9,64,46,86,57,0,44,82,73,100,9,19,100,7,58,81,64,30,30,58,31,78,42,4,8,39,52,"2","0",38,97,31,58,69,4,80,85,71,87,0,13,1,0,41,65,81,59,49,0,61,16,36,65,70,83,13,60,35,17,45,53,59,"0",31,76,47,100,0,36,"0","4",17,3,59,"0",82,85,21,56,58,15,27,14,30,"1","3",0,36,71,0,"<1",29
"2005-03-01",100,39,0,59,14,64,31,34,31,56,32,96,0,24,49,86,11,6,0,2,86,90,89,"1",19,18,0,70,68,29,58,69,85,27,54,7,48,21,55,95,95,18,17,81,90,28,93,45,51,40,85,53,89,62,67,48,72,82,29,16,51,67,61,97,0,34,94,90,0,11,23,0,37,42,8,0,"1",47,36,38,34,49,43,41,38,100,0,35,60,72,25,17,65,88,0,1,"0","0","<1",18,13,13,"2","0",0,"0",28,3,81,"0",25,0,77,65,52,33,64,45,79,71,0,0,"11",68,47,18,96,75,55,78,0,73,8,64,28,65,76,53,39,36,80,67,75,53,6,14,15,77,85,39,46,62,46,10,79,44,72,65,16,59,80,62,34,22,39,71,6,65,67,83,64,37,81,82,50,18,0,6,51,0,"2","0",39,90,79,72,58,0,73,96,82,88,4,8,1,0,49,64,88,59,0,0,37,15,49,44,52,80,44,100,100,35,76,56,42,"0",37,82,34,75,11,21,"0","0",15,6,58,"0",84,81,47,82,53,13,79,0,55,"0","0",0,31,76,0,"<1",49
"2005-04-01",85,58,0,68,65,73,36,28,69,32,43,89,0,68,59,86,36,7,0,7,89,95,100,"<1",22,19,0,27,82,70,64,67,81,12,75,17,50,16,21,85,88,12,0,51,47,31,100,51,21,54,77,51,73,54,65,61,75,89,70,22,56,80,60,81,20,44,91,90,0,10,31,0,38,42,10,0,"1",60,29,46,44,60,47,46,42,36,33,43,0,63,30,6,80,93,0,1,"0","0","<1",20,16,11,"0","0",0,"0",27,3,80,"<1",31,22,80,37,76,57,55,55,88,79,0,0,"12",68,44,0,79,92,39,91,60,77,4,63,45,61,90,60,66,12,93,83,85,36,0,27,41,66,88,55,65,93,43,12,34,44,100,58,0,42,88,42,26,18,18,67,6,78,95,68,56,51,69,30,62,40,4,7,62,100,"0","0",38,86,60,68,73,4,65,93,85,62,0,0,1,47,62,56,70,60,0,0,33,17,63,27,64,75,19,41,0,41,59,61,56,"0",18,82,33,72,24,46,"0","0",18,3,65,"0",93,84,40,80,52,30,32,13,47,"1","0",0,35,79,18,"<1",56
"2005-05-01",82,56,0,66,28,87,32,40,61,61,51,89,0,54,58,86,16,0,0,2,80,82,81,"<1",27,19,0,47,80,71,64,71,82,60,21,15,44,28,73,94,81,8,0,62,59,55,80,51,28,29,69,54,77,52,68,66,71,84,71,12,74,44,57,80,18,64,76,93,58,11,14,0,35,44,3,0,"1",50,16,45,27,39,37,34,35,36,0,41,0,43,24,14,55,58,0,1,"0","0","<1",18,16,13,"0","0",0,"0",25,3,70,"0",22,19,81,33,100,33,47,52,100,75,0,0,"16",20,68,18,72,70,35,62,0,55,5,40,34,64,64,66,29,21,85,71,84,53,7,31,33,75,82,29,70,90,21,10,24,29,75,47,0,53,83,25,28,22,64,69,5,46,63,65,39,59,58,61,50,18,3,10,44,44,"0","1",39,73,44,56,64,0,55,79,78,66,8,11,2,0,58,82,67,32,0,0,44,15,31,50,61,63,11,50,40,21,47,64,57,"0",48,80,45,48,0,41,"0","0",16,3,51,"0",52,77,35,24,76,39,39,34,52,"0","0",0,31,98,0,"<1",37
"2005-06-01",81,100,0,61,15,58,49,21,32,100,33,94,0,38,42,100,0,6,0,2,87,80,83,"1",20,20,0,99,69,65,72,69,88,57,61,0,56,37,38,86,88,22,0,52,49,0,77,53,78,45,72,73,82,47,62,75,78,86,65,14,55,44,68,96,37,53,71,99,61,5,10,0,35,20,6,0,"1",66,22,38,41,39,45,43,25,50,0,26,0,100,35,15,45,58,0,1,"0","0","<1",19,4,11,"3","2",0,"0",27,2,69,"0",12,20,61,34,70,59,56,54,98,100,0,0,"35",46,68,18,66,67,38,54,0,62,5,67,60,67,76,84,81,23,54,67,87,45,0,63,42,71,85,41,70,90,48,13,26,51,72,49,16,50,53,39,36,32,33,51,6,96,89,50,28,54,52,46,57,28,4,11,46,46,"3","2",41,84,55,72,68,7,57,71,100,64,16,20,2,0,75,91,83,78,0,0,62,17,58,55,64,61,23,68,63,31,40,70,73,"0",44,76,42,37,0,0,"2","0",13,3,55,"0",63,44,25,37,58,14,65,30,50,"0","3",0,16,93,0,"<1",26
"2005-07-01",74,56,0,53,22,80,32,46,63,35,46,91,0,37,63,39,11,6,0,3,85,74,97,"<1",20,19,12,60,100,58,74,76,87,22,43,15,46,29,19,85,73,11,0,44,53,57,74,62,43,50,61,89,67,56,59,49,86,68,58,34,57,39,69,81,12,57,62,100,0,9,0,60,25,21,3,0,"2",79,38,54,48,69,71,52,29,66,0,18,0,63,33,23,67,74,0,1,"0","0","<1",0,13,13,"0","0",0,"0",24,3,58,"0",17,20,55,0,84,38,67,77,94,79,0,8,"11",41,57,64,68,48,24,59,0,58,7,49,23,58,77,87,50,7,46,64,100,33,0,30,19,70,76,60,94,100,60,17,82,30,96,63,16,66,40,32,41,28,49,63,5,79,90,74,25,68,76,57,39,46,3,11,68,45,"0","0",38,76,100,84,48,4,53,76,86,64,0,12,3,14,72,76,74,61,0,0,91,17,25,81,52,62,28,7,31,48,78,74,55,"0",38,79,51,36,0,0,"0","0",12,0,53,"0",56,66,30,61,61,27,81,24,38,"0","0",23,16,59,0,"<1",51
"2005-08-01",72,63,0,55,34,40,23,10,44,60,55,90,0,23,56,28,10,6,7,2,80,73,77,"<1",26,23,16,23,83,74,65,95,90,79,44,7,61,68,18,84,72,20,0,46,57,27,68,93,36,63,64,100,66,41,50,70,71,77,74,24,49,70,68,100,23,54,73,98,57,6,9,0,28,23,7,0,"1",100,40,65,65,79,82,72,55,66,0,27,0,63,29,11,90,43,0,1,"0","0","<1",0,14,16,"0","0",0,"0",26,3,60,"0",29,0,72,80,88,55,65,56,86,71,0,0,"32",31,40,17,58,51,30,52,0,51,5,31,49,73,70,64,56,21,50,84,88,20,6,79,63,81,79,74,74,93,49,16,35,47,63,56,0,88,55,42,22,25,38,70,6,100,87,75,70,42,99,31,34,17,3,9,57,43,"0","1",43,75,51,100,96,3,42,66,78,59,8,15,3,0,60,63,53,40,0,0,100,16,72,76,75,50,32,63,39,57,83,72,75,"0",41,76,49,29,0,20,"0","3",11,3,48,"0",55,51,60,57,59,13,60,33,51,"0","0",0,44,73,0,"<1",95
"2005-09-01",69,49,0,62,26,74,21,27,28,61,11,85,0,16,53,52,0,5,0,3,88,93,71,"1",14,20,0,53,61,48,57,69,77,78,67,7,99,25,0,81,84,14,8,64,61,0,88,100,42,100,68,82,87,66,74,49,50,80,48,10,59,54,64,71,37,44,87,93,0,14,33,0,29,34,3,0,"2",36,47,77,63,94,74,81,71,72,0,36,0,62,24,15,75,73,0,1,"0","0","<1",0,5,13,"0","0",0,"0",25,3,75,"<1",27,0,60,45,60,69,39,33,70,64,0,7,"50",40,52,24,76,100,50,79,0,77,5,58,36,63,61,40,52,16,70,72,94,48,6,98,85,99,81,87,69,82,26,16,27,53,82,53,14,43,66,100,66,11,29,93,5,62,83,66,54,40,85,34,56,16,6,8,56,0,"0","0",38,88,88,69,32,3,78,78,63,63,4,7,2,0,41,61,34,48,0,0,67,15,61,64,62,63,100,71,81,61,56,57,78,"0",48,69,47,41,0,37,"2","0",14,0,60,"0",78,71,58,64,66,12,25,94,33,"1","0",0,41,100,0,"<1",55
"2005-10-01",89,43,0,60,48,69,26,41,64,38,91,87,0,30,62,56,9,5,0,1,82,92,67,"1",13,19,9,29,73,82,45,62,74,59,69,6,78,24,23,94,100,15,0,70,82,0,90,62,31,47,70,62,62,78,72,35,51,72,82,14,50,82,60,61,35,48,79,89,0,10,15,0,34,33,6,0,"2",87,35,48,53,54,43,53,31,60,0,29,50,69,24,9,47,74,0,1,"0","0","<1",0,8,15,"1","0",0,"0",26,3,84,"0",16,0,72,28,36,67,53,42,77,67,0,6,"32",37,46,44,73,79,54,71,0,78,5,60,19,53,77,48,57,39,83,62,95,62,5,55,79,71,81,48,59,74,42,14,41,53,74,39,0,45,72,36,14,31,60,71,6,42,55,62,54,46,75,20,64,60,3,8,55,56,"1","0",38,86,52,66,39,3,72,67,70,56,0,19,3,0,43,51,40,40,0,9,56,13,46,57,78,64,14,79,42,43,52,53,72,"0",63,69,39,63,0,35,"0","6",21,2,58,"0",85,80,30,60,62,22,52,24,36,"0","2",0,13,74,7,"<1",21
"2005-11-01",74,52,0,44,24,90,20,30,26,53,82,79,0,36,61,57,0,0,0,1,78,81,68,"<1",26,17,0,60,76,76,44,49,73,42,71,13,54,42,31,81,90,11,0,75,58,71,78,47,20,38,62,35,75,100,62,46,54,68,76,11,74,65,58,64,35,40,96,88,50,5,8,0,38,43,7,0,"1",49,36,48,44,42,31,41,32,58,0,35,0,63,22,7,61,79,0,1,"0","0","<1",15,11,18,"1","1",0,"0",26,2,74,"<1",26,17,73,28,70,54,58,29,92,59,0,0,"19",48,45,23,67,75,51,60,0,83,9,41,58,43,64,30,50,28,91,71,82,45,8,35,37,66,78,58,60,80,79,13,94,42,71,47,13,55,61,63,49,23,61,84,7,39,58,65,40,45,72,25,45,31,6,7,47,38,"1","1",37,80,45,60,60,3,72,86,55,53,3,16,3,0,37,44,35,33,0,0,44,13,42,49,66,67,28,74,51,19,49,49,52,"0",23,69,38,61,9,26,"5","12",27,7,66,"4",81,85,35,41,53,0,48,30,30,"0","0",0,26,87,7,"<1",21
"2005-12-01",73,60,0,43,41,34,32,40,75,37,41,76,0,10,40,70,9,0,0,1,67,71,54,"1",12,11,18,76,76,67,46,51,72,35,47,6,69,35,0,66,79,11,0,56,63,22,69,34,23,24,61,60,51,63,41,34,46,67,67,17,51,49,61,35,48,52,65,97,0,7,15,0,31,33,4,0,"2",41,34,49,57,41,31,33,22,49,0,29,0,47,18,5,65,48,0,1,"0","0","<1",15,9,14,"1","0",0,"0",22,2,57,"0",18,0,57,54,82,62,46,33,63,54,0,6,"13",16,100,22,64,43,31,61,0,63,5,45,37,37,52,40,63,15,71,65,76,61,5,26,15,58,65,39,49,65,58,11,79,32,78,41,13,100,55,35,32,14,32,50,5,50,67,52,30,23,58,31,41,44,0,9,45,0,"1","1",35,70,43,70,52,3,68,58,56,58,6,18,3,0,33,47,41,34,0,0,54,12,45,64,54,60,18,70,24,23,39,49,62,"0",26,58,26,39,0,25,"0","6",15,2,48,"0",55,73,17,48,41,11,46,28,28,"0","0",0,0,75,0,"<1",0
"2006-01-01",70,74,0,64,21,67,29,32,100,24,65,88,0,30,58,42,8,0,0,2,83,77,70,"1",8,17,0,85,84,49,54,71,80,28,39,11,59,21,20,82,91,15,6,57,56,100,78,50,17,29,66,60,72,62,53,52,75,80,49,14,48,64,61,53,26,56,75,94,0,6,13,0,35,36,3,0,"2",58,42,47,32,51,44,48,25,44,0,29,0,86,33,12,76,63,0,1,"0","0","<1",13,5,15,"1","0",0,"0",26,3,73,"<1",26,14,66,48,59,62,46,49,79,63,4,5,"16",41,53,26,71,64,32,73,0,56,6,29,37,61,77,39,56,26,69,82,77,85,5,23,34,77,78,14,60,66,43,14,31,53,92,53,0,70,64,27,16,20,23,66,6,70,85,82,39,37,88,51,52,26,7,9,51,32,"1","0",38,80,58,88,77,3,56,75,67,50,9,14,3,0,55,60,68,54,0,0,38,15,9,42,51,67,48,37,51,30,79,60,59,"0",43,77,47,55,8,15,"0","0",18,3,52,"0",78,75,51,60,60,9,61,21,41,"0","2",16,0,64,0,"<1",71
"2006-02-01",81,58,0,61,32,55,42,41,35,47,43,89,0,27,42,22,24,5,0,2,78,92,63,"1",23,21,9,97,70,53,53,61,77,21,72,6,70,21,41,72,89,26,13,66,82,21,81,51,32,26,66,66,66,59,60,36,75,83,53,17,71,88,62,55,40,53,85,93,43,11,10,0,41,32,3,0,"3",40,43,34,25,41,29,41,25,36,0,33,0,58,28,11,70,73,0,1,"0","1","<1",27,11,13,"2","0",0,"0",26,3,72,"0",27,29,74,37,68,69,48,42,75,73,0,11,"33",39,87,33,71,58,48,70,0,75,7,36,43,56,48,47,51,30,80,81,71,40,5,38,41,74,78,65,51,52,48,15,69,59,68,51,12,28,67,37,39,23,54,79,6,69,80,71,100,37,62,51,74,14,3,9,58,0,"2","0",35,70,60,71,49,5,67,86,65,69,3,12,3,0,32,57,47,42,0,8,22,16,33,65,79,70,46,66,45,18,50,58,59,"0",28,77,40,48,0,16,"4","3",25,2,56,"4",71,56,100,27,45,0,64,48,30,"1","0",0,12,67,12,"12",37
"2006-03-01",86,48,0,42,33,100,63,46,61,59,34,87,0,16,57,13,14,8,5,2,78,83,72,"1",35,18,7,39,78,47,53,53,78,61,55,5,46,61,12,89,79,26,0,76,72,0,87,53,21,25,69,57,68,61,69,28,61,70,47,20,60,70,61,55,35,49,70,90,0,8,6,0,38,34,6,0,"3",55,34,43,32,44,42,46,23,37,0,29,0,57,26,15,100,66,0,1,"0","0","<1",24,10,13,"0","2",0,"0",25,2,82,"<1",15,38,72,44,85,39,46,47,68,72,0,0,"25",50,52,12,77,58,39,66,0,83,6,84,30,50,64,56,38,21,80,73,94,56,4,37,31,76,79,19,56,65,42,14,89,42,71,47,0,49,66,24,37,16,100,84,8,58,75,76,41,32,69,58,69,35,0,10,53,29,"0","2",36,80,47,73,85,2,60,69,71,37,5,12,4,9,52,65,46,41,0,0,49,17,57,28,66,70,22,38,53,26,60,58,70,"0",60,72,43,53,7,13,"2","0",19,3,60,"3",51,82,23,63,57,17,78,15,37,"1","2",0,10,63,5,"9",33
"2006-04-01",81,71,0,73,15,61,22,48,64,24,45,84,0,21,67,41,0,4,0,2,81,91,69,"1",19,21,8,66,94,41,61,59,78,42,52,18,76,50,51,79,78,15,6,92,58,20,81,77,46,53,72,78,62,59,51,63,70,73,41,20,68,64,63,59,33,51,88,92,0,7,6,0,41,41,3,0,"4",35,48,52,51,61,49,63,45,42,0,34,42,54,28,10,56,77,0,1,"0","1","<1",12,18,14,"2","0",0,"0",27,8,71,"<1",21,0,71,93,44,75,45,45,86,74,0,0,"35",45,40,37,75,85,43,59,0,78,5,39,36,52,73,40,88,20,77,79,81,15,9,49,38,68,77,48,64,70,55,14,43,27,73,46,11,60,71,35,28,23,72,72,8,65,56,61,70,54,80,37,60,25,2,10,31,31,"2","0",34,72,25,75,74,5,74,85,68,75,8,11,6,10,47,61,47,46,0,0,16,16,39,52,59,65,54,65,56,59,57,57,56,"0",63,71,46,61,7,14,"3","5",21,5,60,"0",66,78,64,33,49,18,79,45,42,"0","0",31,22,80,0,"8",35
"2006-05-01",63,55,0,71,28,67,21,16,71,30,46,82,0,16,47,38,10,6,0,4,76,77,69,"1",15,15,15,46,53,41,58,57,78,43,77,5,78,47,24,87,75,21,6,58,63,0,74,88,34,47,64,54,68,58,60,63,64,67,41,12,54,67,63,46,19,59,68,91,39,5,21,38,37,44,5,0,"4",46,27,64,67,70,66,59,45,34,0,40,0,72,27,7,81,52,0,1,"0","0","<1",0,8,15,"0","0",0,"0",24,5,69,"0",9,13,67,65,69,88,56,50,75,64,0,0,"29",76,40,17,75,73,30,67,0,62,6,58,45,52,83,70,45,17,74,72,81,56,9,73,72,72,73,25,46,71,47,16,28,39,71,44,10,32,76,57,52,29,37,57,7,61,67,58,59,50,69,35,47,53,7,11,41,29,"0","1",40,71,47,71,89,3,49,83,80,61,8,10,6,9,57,61,71,43,0,10,39,16,41,59,57,59,18,47,33,39,81,59,67,"0",46,74,45,34,0,20,"0","5",17,0,49,"0",51,64,43,86,48,17,48,49,41,"1","0",0,50,69,0,"10",57
"2006-06-01",67,94,0,46,50,58,60,38,32,24,53,83,0,42,56,47,11,4,0,2,76,72,67,"1",16,21,8,49,58,74,63,59,81,34,61,5,51,20,26,80,82,29,0,38,63,39,72,58,46,43,64,54,71,37,54,83,68,60,74,21,38,55,69,48,17,58,79,92,0,6,0,0,29,22,2,0,"5",35,22,56,53,57,64,60,31,50,0,34,0,73,28,21,78,58,0,1,"0","0","<1",12,9,13,"1","0",0,"0",24,2,54,"<1",14,13,55,70,54,62,51,61,69,73,0,0,"39",50,44,12,56,40,29,59,0,52,4,33,16,54,80,40,68,25,52,71,84,30,5,27,25,66,75,41,47,65,29,18,60,58,79,40,22,41,48,39,36,25,61,59,6,54,72,65,25,46,67,53,47,12,4,10,46,46,"1","0",43,67,49,74,49,6,48,72,69,64,3,18,7,10,52,54,80,46,0,0,57,18,26,68,37,56,66,50,84,37,30,58,86,"0",85,74,50,21,15,0,"0","0",12,2,46,"0",45,58,33,74,56,9,47,36,52,"0","0",0,0,64,0,"8",68
"2006-07-01",59,79,0,47,58,50,16,14,31,65,35,79,0,53,29,46,14,12,0,2,79,63,65,"<1",5,16,15,96,89,73,70,64,84,41,62,10,60,29,12,67,75,14,0,32,74,37,60,68,48,45,57,79,57,39,36,37,79,64,73,20,41,48,72,63,24,53,61,94,0,4,25,0,27,21,2,0,"4",41,46,68,61,72,60,66,34,36,0,22,0,86,23,13,84,48,9,1,"0","0","<1",0,6,11,"0","0",0,"0",23,3,51,"0",13,0,45,45,78,59,65,72,97,68,0,0,"19",35,30,24,53,56,16,47,0,52,5,76,35,46,78,67,59,24,32,60,79,73,4,49,57,65,70,20,41,65,32,18,71,63,79,42,0,66,39,38,23,25,71,64,5,58,75,56,31,46,79,60,41,18,5,9,50,30,"0","0",42,58,66,94,100,5,31,68,73,63,5,21,6,10,68,71,67,69,0,0,35,18,55,82,86,42,45,20,48,54,62,65,66,"0",44,76,55,23,0,0,"0","0",12,0,40,"0",32,44,18,73,63,9,69,24,55,"0","0",0,16,67,6,"9",50
"2006-08-01",59,58,0,44,31,40,5,15,38,25,80,82,0,38,31,66,20,4,0,2,76,65,69,"<1",19,17,11,73,67,63,60,73,82,51,62,7,55,31,11,77,80,25,5,39,71,0,68,88,58,44,66,64,62,43,46,41,67,57,63,14,43,48,72,55,22,49,65,93,0,3,0,0,25,21,4,0,"4",33,49,64,61,59,60,58,35,35,0,29,0,74,30,12,64,33,0,1,"0","1","<1",11,10,10,"0","1",5,"0",25,3,55,"0",7,0,63,52,51,85,62,50,69,79,4,9,"38",42,44,33,59,55,25,47,0,51,4,65,39,53,78,69,30,34,38,59,71,13,4,41,46,67,72,49,42,68,23,21,76,58,74,56,0,33,47,43,36,16,54,64,6,50,69,59,27,54,83,35,42,100,2,11,53,27,"0","1",42,54,50,99,66,4,41,63,65,63,2,12,6,17,50,63,49,65,0,0,46,17,35,59,66,41,17,49,75,53,83,62,71,"2",40,76,51,30,0,19,"1","2",14,2,45,"0",34,38,33,89,55,8,92,32,45,"0","2",0,19,63,0,"9",38
"2006-09-01",61,72,0,71,35,49,30,31,67,28,52,77,0,45,59,30,10,8,0,3,76,85,58,"<1",12,17,11,15,73,31,51,64,74,37,67,14,51,49,45,89,78,15,5,53,86,0,80,45,32,34,66,62,63,53,57,60,52,63,31,21,52,66,68,50,26,49,68,89,0,3,6,0,32,30,3,0,"4",65,13,57,36,69,58,59,13,15,0,32,0,81,25,17,77,58,8,1,"0","0","<1",11,4,12,"0","0",0,"0",25,3,69,"0",28,12,69,72,60,47,54,28,63,71,0,0,"21",35,37,16,71,55,33,80,0,66,2,45,39,59,58,75,54,36,61,57,79,53,8,29,52,75,73,30,40,60,29,16,68,39,79,43,10,43,63,38,42,25,50,82,9,45,51,68,39,56,60,22,44,33,3,13,48,28,"0","1",42,61,66,79,69,4,52,64,56,58,0,16,5,9,46,53,58,42,0,6,28,15,42,44,55,63,14,63,37,28,65,53,66,"0",30,68,42,54,13,0,"0","2",19,3,48,"0",63,64,46,37,48,8,81,29,34,"0","2",14,10,65,8,"8",30
"2006-10-01",69,50,0,40,24,52,13,17,35,41,43,80,0,31,68,38,12,7,0,3,77,89,54,"1",28,21,13,40,62,44,47,53,74,12,71,4,38,56,42,78,84,18,5,51,80,0,80,46,32,27,70,73,67,58,60,44,49,65,44,13,51,79,66,38,20,54,77,86,33,8,13,0,33,25,6,0,"4",51,36,42,39,57,46,52,22,21,0,30,34,75,22,11,77,63,0,1,"0","1","<1",10,17,13,"3","0",0,"0",26,3,70,"<1",17,11,61,28,73,37,46,32,84,77,0,0,"6",25,43,35,64,83,37,58,0,67,4,45,35,55,80,73,55,18,67,61,80,72,7,15,10,68,74,38,54,76,31,14,35,33,72,40,18,55,71,18,29,24,41,72,8,46,80,70,31,38,57,40,47,46,5,11,46,75,"3","0",46,67,15,77,67,9,57,63,60,68,7,11,5,8,45,50,50,51,0,0,55,13,63,57,53,71,25,49,23,23,68,54,67,"0",33,70,45,48,12,24,"0","0",18,3,52,"0",59,62,22,74,43,22,51,26,31,"0","2",51,13,40,9,"8",28
"2006-11-01",57,56,0,55,20,62,36,64,52,29,86,74,0,20,43,22,12,3,0,3,73,78,51,"<1",17,21,13,27,43,38,44,51,73,21,52,8,37,52,26,76,77,18,0,57,57,16,69,48,26,22,63,40,61,60,61,44,47,65,38,18,57,60,64,42,43,43,70,88,33,5,10,0,35,32,3,0,"3",45,26,43,34,45,43,43,22,18,0,34,0,68,23,14,73,63,0,1,"0","0","<1",0,11,13,"2","1",0,"0",26,1,60,"0",12,0,62,37,62,36,58,36,52,64,0,0,"12",32,66,10,71,72,43,65,0,66,4,14,35,47,47,48,27,40,67,62,72,48,11,30,16,62,71,55,50,51,47,14,69,25,71,44,0,45,63,17,22,18,63,72,5,32,69,56,35,38,61,28,46,15,2,8,56,25,"2","1",46,63,60,65,60,6,54,73,57,49,7,13,5,0,50,52,39,37,0,6,33,13,49,56,53,56,22,28,45,20,81,46,62,"0",45,61,40,43,6,23,"1","2",21,2,54,"3",48,68,30,20,43,7,51,10,22,"0","0",0,17,70,0,"7",21
"2006-12-01",49,49,0,34,33,95,45,31,88,61,95,66,0,10,48,38,6,3,0,2,65,64,42,"1",13,12,13,13,59,70,43,47,71,37,88,9,43,57,37,62,70,24,0,42,52,0,64,50,19,23,50,59,54,69,54,14,42,54,70,17,53,46,70,32,27,62,67,97,33,6,10,0,33,29,4,34,"4",59,30,50,54,43,30,39,16,21,17,34,0,63,17,11,66,49,7,1,"0","0","<1",0,5,13,"2","1",0,"0",21,2,49,"<1",13,0,43,57,88,39,37,35,42,50,0,0,"9",30,59,15,60,57,24,52,0,59,3,32,46,45,47,51,28,37,63,57,65,73,0,19,19,56,58,22,28,39,51,14,63,28,80,27,13,37,52,39,29,16,18,40,6,31,60,54,33,33,69,27,40,15,5,10,40,63,"2","1",44,57,41,57,60,7,41,65,52,63,2,11,5,0,39,48,49,42,0,0,42,14,67,59,43,54,10,29,46,24,44,44,61,"0",58,57,38,39,6,24,"1","2",13,2,44,"0",48,53,29,61,42,11,65,23,21,"0","2",13,9,64,5,"7",78
"2007-01-01",67,62,0,39,14,82,60,28,23,14,52,83,0,27,52,58,0,5,0,2,79,76,52,"<1",19,21,34,36,75,38,56,68,79,50,70,10,42,54,32,80,77,20,0,48,71,14,69,43,40,25,66,78,74,72,61,46,68,68,38,21,55,65,69,63,39,39,70,95,0,8,9,30,36,30,5,31,"5",49,24,40,27,48,25,44,16,31,0,39,0,77,31,11,72,50,0,1,"0","0","<1",9,7,16,"1","0",0,"0",27,2,64,"<1",20,0,58,42,85,43,54,41,52,55,0,0,"20",47,48,18,65,83,30,50,0,60,8,32,46,47,84,43,29,26,59,68,74,97,3,28,17,67,73,44,56,60,32,16,68,40,72,53,0,46,58,16,23,15,57,64,8,62,60,80,36,41,68,48,44,32,4,11,50,23,"1","1",47,66,67,77,92,2,58,70,65,52,4,10,7,0,46,58,81,60,0,0,38,18,56,60,53,49,22,44,61,28,65,59,72,"0",51,81,49,29,5,26,"1","5",13,1,51,"5",64,68,31,30,58,13,60,35,31,"0","0",0,8,56,10,"8",19
"2007-02-01",58,55,0,50,8,64,63,53,49,42,31,83,0,39,41,41,0,0,0,3,79,91,55,"<1",12,21,9,76,68,48,56,63,81,29,53,12,59,15,29,75,76,18,0,58,63,0,78,41,15,30,64,51,65,47,59,61,62,66,48,20,60,69,72,44,25,49,75,92,0,7,10,0,32,34,3,32,"6",32,34,35,32,52,38,45,17,24,0,37,32,71,28,9,73,70,7,1,"0","1","<1",10,9,14,"1","1",0,"0",26,3,64,"<1",13,21,58,62,56,57,44,43,62,50,0,6,"24",34,65,19,68,50,32,60,0,71,7,43,49,57,66,62,57,31,60,61,79,51,0,19,27,67,75,41,61,52,49,17,43,44,59,38,0,37,55,36,33,26,38,67,7,74,68,67,32,44,77,55,54,48,5,12,41,48,"1","1",45,57,85,66,82,9,61,93,66,64,2,6,7,0,52,58,62,46,0,6,40,18,20,46,55,54,27,54,86,27,46,57,86,"2",57,76,37,35,11,11,"0","0",18,3,55,"0",39,50,28,51,43,7,100,22,42,"0","0",0,16,49,4,"11",13
"2007-03-01",49,55,0,55,31,59,49,45,29,22,49,85,0,12,46,41,10,3,0,1,77,80,62,"<1",33,18,11,51,48,48,57,56,80,36,60,13,49,37,17,78,67,35,0,59,68,13,74,41,33,25,63,58,58,54,50,26,70,60,48,22,63,62,71,75,25,54,69,87,28,11,13,28,42,35,4,0,"7",21,35,43,29,49,49,50,21,36,0,34,29,54,28,20,42,49,0,1,"0","0","<1",0,7,13,"1","1",0,"0",25,3,61,"<1",11,0,63,55,41,49,46,45,61,55,0,3,"8",33,39,8,65,76,39,58,26,65,5,61,44,56,76,40,42,27,67,62,79,31,9,24,33,65,70,28,38,56,44,17,82,35,69,36,8,56,57,12,24,13,53,69,7,46,71,70,28,36,79,51,45,17,3,8,56,21,"1","1",47,53,72,68,90,10,49,70,57,72,15,14,9,7,53,65,76,48,0,5,39,19,47,38,52,60,19,31,58,25,68,53,63,"0",59,76,42,32,13,29,"1","0",21,4,49,"0",55,70,34,45,45,6,60,33,44,"0","0",21,22,53,4,"10",12
"2007-04-01",65,49,0,57,27,80,27,36,81,16,71,83,0,29,52,41,10,6,0,3,72,75,54,"<1",22,22,0,73,61,55,58,60,76,16,74,7,73,54,44,75,66,5,0,42,100,0,76,52,18,45,65,42,57,60,57,43,63,62,55,20,55,61,70,53,28,39,79,86,0,10,18,0,38,42,4,0,"8",29,45,46,36,56,58,53,25,27,0,43,0,66,27,17,55,57,6,1,"0","0","<1",17,9,13,"0","0",0,"0",25,3,66,"0",15,9,59,16,55,77,45,45,65,67,0,3,"24",25,28,17,71,48,40,56,0,64,4,50,30,56,71,64,65,36,60,62,77,46,0,30,47,61,70,42,44,59,24,17,79,30,71,46,7,28,56,33,27,15,42,70,6,41,67,56,35,38,72,64,53,21,6,9,42,32,"0","1",48,59,38,65,70,12,68,86,65,59,8,20,10,13,50,55,59,43,0,5,82,18,50,70,63,63,34,49,53,34,62,55,64,"0",54,78,46,43,5,25,"0","3",19,1,53,"0",61,81,34,40,41,9,49,30,42,"1","3",22,15,43,0,"9",24
"2007-05-01",63,44,0,60,34,84,38,35,27,22,36,81,0,42,44,38,21,5,3,3,71,71,54,"1",12,21,12,67,42,65,65,66,81,21,65,18,72,40,16,77,75,30,0,55,68,24,64,69,20,51,62,33,57,39,56,29,67,58,65,18,55,59,68,47,31,51,66,86,0,5,22,0,42,48,3,26,"8",47,36,57,48,62,55,66,42,18,0,47,0,54,30,16,68,56,6,1,"0","0","<1",16,5,12,"2","0",0,"0",24,6,56,"<1",13,8,59,50,31,66,56,43,81,54,5,3,"38",31,50,8,65,82,35,47,23,62,4,42,40,50,86,50,64,31,64,65,76,79,7,48,41,63,71,38,37,64,35,21,56,38,64,50,14,42,57,16,37,19,35,65,8,50,60,66,33,43,72,63,30,39,4,12,56,39,"2","0",53,60,62,54,59,10,54,72,58,59,7,12,11,6,45,56,67,51,0,5,52,21,46,56,56,61,39,25,39,53,48,61,77,"0",52,75,56,39,19,41,"2","0",17,3,45,"0",60,71,31,68,55,9,49,45,55,"0","4",20,13,55,0,"9",27
"2007-06-01",54,49,0,58,40,52,7,30,79,37,48,84,0,48,33,54,15,6,4,2,77,65,56,"1",4,18,5,55,44,96,70,66,89,44,100,14,62,30,17,76,73,22,0,46,80,26,60,69,50,50,63,45,52,48,50,28,70,65,96,17,49,50,73,46,25,73,61,89,0,5,15,27,37,31,3,28,"9",42,34,55,50,70,62,59,27,34,0,30,0,65,28,17,79,39,0,1,"0","0","<1",8,9,12,"2","0",0,"0",26,3,56,"<1",16,9,59,86,56,52,60,60,64,55,0,5,"23",19,44,17,53,41,27,46,0,57,6,34,46,70,83,67,69,46,43,71,72,80,8,35,28,62,71,73,42,55,28,21,43,35,80,56,7,53,44,29,40,28,53,57,8,56,64,59,22,68,83,49,36,25,3,16,42,42,"2","1",50,48,33,64,66,13,53,60,59,80,4,21,13,7,62,68,74,49,0,5,42,23,73,53,78,47,29,24,61,46,54,65,68,"0",40,77,46,24,10,10,"0","3",21,2,48,"0",53,64,19,67,67,9,72,19,52,"1","0",32,7,60,0,"10",17
"2007-07-01",61,47,0,42,57,35,21,31,27,33,60,84,0,59,37,47,5,8,3,3,75,64,57,"1",10,21,10,73,51,62,76,67,89,27,67,15,61,22,8,72,67,23,0,41,59,0,60,53,42,41,60,58,57,36,51,40,78,58,62,29,47,57,75,42,32,51,64,90,52,6,12,0,34,26,2,27,"9",42,49,54,54,69,68,62,22,36,0,27,0,65,25,12,82,50,0,1,"0","<1","<1",16,11,16,"1","1",0,"0",27,4,61,"<1",14,0,43,22,47,55,68,59,60,50,3,6,"10",34,62,0,56,60,20,34,0,47,4,46,38,72,74,55,47,21,38,66,71,67,6,32,20,62,68,51,44,64,36,26,52,41,85,57,0,62,38,22,41,13,57,53,7,58,65,55,18,49,90,58,34,20,5,12,53,20,"1","2",50,52,91,73,78,10,48,69,64,86,14,13,13,12,53,74,92,56,0,14,46,22,69,56,70,44,25,42,72,36,64,67,68,"0",31,79,62,26,12,18,"0","5",23,6,61,"0",30,49,20,59,61,9,96,28,56,"1","1",10,7,65,4,"10",11
"2007-08-01",57,60,0,44,36,45,34,30,85,43,27,86,0,44,39,28,18,6,13,4,74,61,64,"1",2,22,14,55,59,57,67,77,84,35,55,14,52,27,35,80,65,22,0,35,61,47,60,56,22,41,61,71,50,41,46,31,67,61,57,22,54,57,76,44,25,48,61,89,0,4,18,25,27,23,1,0,"10",37,49,48,35,56,53,52,23,26,0,33,26,74,30,24,82,48,6,1,"0","0","<1",15,7,14,"1","1",0,"0",26,4,54,"<1",15,12,54,56,47,54,56,65,73,65,7,3,"7",17,62,19,50,47,19,50,0,46,4,82,48,64,87,57,78,44,40,57,83,64,11,23,19,65,69,58,57,70,43,25,44,42,72,57,7,50,47,42,27,21,41,65,6,39,66,62,18,53,95,39,52,23,9,13,53,38,"1","1",49,51,68,69,77,7,32,67,66,77,19,24,12,6,51,60,66,56,0,0,31,23,58,55,68,44,24,28,56,33,57,63,85,"0",32,80,47,24,5,18,"0","1",17,3,43,"0",47,44,19,71,61,8,80,25,60,"<1","0",38,13,65,3,"9",21
"2007-09-01",64,49,0,51,18,51,20,17,52,81,62,82,0,36,71,32,4,10,5,4,76,83,50,"1",10,24,12,35,50,57,54,60,78,39,72,14,51,45,23,82,75,21,4,56,64,35,70,51,36,39,62,49,57,54,49,54,53,58,57,18,59,75,70,46,38,37,74,80,25,9,10,0,35,30,4,0,"8",54,49,39,32,50,38,44,20,32,0,43,0,74,31,23,62,61,5,1,"0","0","<1",15,7,19,"3","1",0,"2",27,5,71,"<1",25,12,59,56,65,54,51,44,65,54,2,3,"19",19,55,11,66,35,46,54,0,66,5,41,41,58,70,57,37,38,59,72,76,41,6,31,15,76,72,49,52,63,20,20,54,37,80,50,13,45,59,47,43,27,44,94,9,52,60,65,12,46,64,40,43,0,6,13,69,38,"3","2",48,55,53,59,80,10,51,77,64,85,8,16,10,9,39,53,48,31,18,13,53,18,71,59,59,58,35,43,60,32,63,55,74,"0",48,77,57,59,0,18,"0","1",25,2,52,"2",55,65,10,91,54,17,67,17,37,"<1","0",9,13,59,7,"9",21
"2007-10-01",71,42,0,53,22,87,39,51,58,68,65,89,0,30,53,22,6,8,9,3,80,87,54,"1",25,23,4,67,42,47,54,56,76,52,73,9,46,40,28,80,81,20,3,58,77,11,78,51,46,36,65,49,63,55,46,52,51,65,47,17,60,76,66,44,56,53,78,79,22,8,24,0,37,35,5,0,"8",25,34,43,33,45,42,46,19,43,0,37,0,58,29,13,65,64,15,2,"0","1","1",14,10,19,"3","2",0,"0",29,9,70,"<1",15,22,57,31,40,51,50,38,58,55,2,3,"17",29,54,30,64,51,42,54,20,71,8,42,45,60,68,37,37,45,66,68,71,73,5,30,32,68,76,40,31,56,40,20,74,20,71,44,9,53,59,49,24,24,45,76,12,41,71,69,24,39,72,40,53,10,6,12,38,67,"3","2",53,61,57,57,67,12,60,74,54,67,7,9,11,8,41,45,40,32,47,8,34,18,66,52,61,60,46,57,69,28,56,53,77,"1",32,77,42,46,4,20,"1","0",24,2,60,"4",72,69,21,63,56,15,52,20,38,"<1","1",8,17,58,6,"9",33
"2007-11-01",59,41,0,64,43,70,21,37,52,100,58,82,0,25,43,32,12,10,7,2,73,74,50,"1",30,22,11,53,40,63,45,60,74,45,91,10,47,46,41,74,75,32,6,55,65,21,66,75,56,48,57,42,55,67,52,43,42,66,63,15,66,63,65,54,49,40,81,80,22,14,17,22,40,36,7,23,"8",32,63,53,53,51,51,50,27,44,0,43,46,56,23,23,64,53,5,1,"0","0","<1",7,17,18,"3","1",0,"2",26,3,76,"<1",18,26,46,81,47,36,52,37,58,62,2,3,"33",39,71,37,61,82,34,51,20,68,6,42,28,52,64,59,44,33,67,58,71,56,5,54,48,62,70,22,37,45,38,18,76,42,73,48,6,69,55,23,30,16,36,63,8,25,63,59,35,35,80,39,46,20,6,14,26,33,"3","1",49,67,40,52,82,10,60,74,52,63,12,17,10,16,36,42,42,35,0,6,31,17,63,69,50,56,29,44,49,42,40,48,69,"0",43,72,47,43,4,39,"1","1",30,4,56,"0",58,68,28,36,50,17,56,33,35,"1","0",0,9,46,3,"8",37
"2007-12-01",52,46,0,51,22,76,25,16,48,95,63,72,0,17,35,23,8,8,9,4,61,65,44,"1",9,14,4,42,36,75,49,56,75,37,80,10,35,45,25,61,69,18,0,33,59,11,60,52,35,43,52,41,45,48,37,24,41,48,75,18,53,51,68,38,40,49,60,88,0,9,22,23,40,34,6,24,"7",55,43,51,65,46,44,47,28,19,0,38,0,66,25,8,79,53,0,1,"0","0","<1",7,4,15,"1","1",0,"0",23,3,54,"<1",13,11,42,59,43,40,46,35,76,62,0,6,"20",47,75,31,60,42,30,54,21,53,3,16,52,47,57,42,73,37,57,62,69,71,8,36,20,59,58,19,37,49,38,16,82,37,71,43,6,63,45,34,36,13,25,57,5,27,52,52,26,39,61,46,36,28,7,10,42,26,"1","1",47,58,45,55,60,8,57,57,52,63,2,24,10,0,29,46,43,37,0,6,41,18,100,85,58,46,35,43,32,32,79,50,73,"0",49,64,36,34,6,37,"0","0",24,2,48,"2",59,68,14,33,49,10,71,32,25,"<1","0",0,18,50,5,"7",44
"2008-01-01",65,58,4,60,32,58,33,34,59,71,40,85,0,27,38,30,13,11,14,3,77,72,54,"1",16,22,8,57,62,57,57,73,84,42,52,7,51,49,22,75,84,16,3,44,78,58,68,57,50,39,63,55,55,53,56,40,64,53,57,22,56,54,70,93,47,47,64,82,20,6,33,0,48,38,4,21,"9",49,36,43,31,48,40,44,29,28,0,38,0,58,34,23,59,51,4,1,"0","0","<1",9,5,17,"2","2",0,"0",28,4,63,"<1",10,17,58,75,42,49,68,42,76,63,4,0,"33",26,58,25,58,77,31,55,0,78,4,45,50,72,78,68,71,30,55,74,65,63,3,43,33,70,70,30,56,72,38,21,49,37,86,53,11,75,54,37,38,19,22,47,9,48,68,69,34,53,79,40,36,16,6,13,48,16,"2","1",45,62,71,68,86,12,57,75,54,57,16,33,12,7,42,62,59,56,0,5,31,23,69,62,68,49,21,68,59,45,46,65,76,"0",52,86,55,42,4,29,"0","1",20,3,52,"0",69,89,33,82,63,21,45,34,39,"1","0",15,21,58,3,"9",47
"2008-02-01",68,64,0,47,33,61,23,32,66,77,60,83,0,45,53,34,6,8,24,5,77,83,49,"1",11,18,8,38,45,54,59,66,82,65,66,12,34,51,26,72,85,13,0,63,75,59,72,54,38,43,64,45,59,48,63,43,62,68,54,21,79,70,71,62,40,44,75,79,0,7,20,42,51,41,8,22,"9",38,53,40,33,48,33,54,29,29,11,46,22,65,34,13,72,64,0,1,"0","0","<1",10,12,24,"1","3",0,"0",30,3,77,"<1",15,14,57,36,50,35,58,43,70,68,6,8,"40",45,73,19,68,68,39,56,38,72,8,26,41,59,76,46,59,40,63,69,74,69,6,40,22,65,70,38,76,99,51,20,57,51,79,44,14,56,55,24,35,21,23,90,9,39,58,63,34,44,77,35,64,29,11,11,50,0,"1","3",38,65,51,55,80,11,66,88,59,75,20,35,12,17,37,58,65,58,15,13,37,25,91,49,45,56,48,73,58,44,70,62,74,"0",38,81,43,50,11,15,"3","2",26,4,54,"0",66,80,34,64,56,5,77,31,44,"<1","1",24,17,59,6,"10",35
"2008-03-01",66,58,0,63,38,61,42,40,64,73,67,85,0,19,54,47,7,3,8,4,75,78,55,"1",15,27,12,29,62,54,65,64,82,46,70,8,72,27,35,70,80,27,3,54,63,10,72,79,74,62,65,45,61,59,60,59,62,60,54,21,63,63,71,54,29,54,75,79,0,10,43,20,54,50,11,53,"10",34,44,48,39,60,48,56,48,20,0,44,21,76,32,22,78,61,5,1,"0","0","<1",6,9,17,"1","2",0,"0",27,3,66,"<1",18,27,53,40,34,60,59,49,87,71,0,3,"42",36,51,28,59,66,41,56,37,72,5,45,64,68,77,70,48,36,60,66,70,93,6,63,60,65,69,30,54,71,49,23,71,34,75,51,38,49,55,39,34,17,37,53,9,50,61,65,48,46,80,59,59,28,9,13,34,16,"1","1",41,64,50,58,60,11,67,86,60,74,11,21,13,24,48,59,63,47,15,31,36,28,74,65,59,50,27,66,95,71,55,56,58,"0",60,87,48,40,7,43,"1","2",27,2,58,"0",62,74,37,67,64,9,73,69,44,"<1","0",79,24,68,6,"11",35
"2008-04-01",69,63,0,59,27,87,51,56,63,77,57,89,0,23,56,39,11,10,100,4,77,82,52,"1",20,23,15,52,47,55,67,67,80,75,66,10,86,46,100,77,83,26,3,70,74,47,69,75,69,61,69,61,64,57,60,39,67,65,55,18,65,73,73,57,30,55,81,78,100,100,88,100,78,95,100,62,"11",46,61,62,52,70,64,65,68,36,100,100,21,59,38,24,79,67,0,1,"0","0","<1",15,11,18,"2","2",0,"2",28,5,68,"<1",16,96,64,45,44,65,61,44,80,79,2,7,"44",66,52,100,66,76,44,64,100,74,6,85,51,64,88,55,66,49,65,66,85,47,6,66,74,63,74,53,49,59,52,23,52,33,72,56,70,42,72,25,35,21,41,61,8,37,56,65,43,42,70,43,55,37,100,14,42,15,"2","1",37,68,64,61,58,17,70,84,55,71,7,100,14,5,39,63,51,45,42,83,61,27,80,67,52,62,38,59,41,69,50,66,72,"0",47,86,52,56,7,78,"1","1",25,1,60,"0",74,97,45,49,71,9,66,42,50,"1","2",76,100,71,3,"11",38
"2008-05-01",57,53,0,82,57,54,16,22,32,78,60,77,0,31,39,20,20,4,87,4,68,68,48,"1",7,19,20,73,43,49,65,69,85,85,62,10,100,22,85,73,74,27,3,48,63,29,62,97,100,84,65,44,62,60,55,31,65,62,49,21,58,61,76,47,39,54,67,77,71,92,65,61,70,100,38,52,"11",45,92,89,83,83,84,90,100,35,40,84,0,62,30,21,74,50,4,1,"0","0","<1",15,8,14,"1","1",0,"0",23,3,54,"<1",17,100,56,57,30,100,56,52,72,73,0,0,"100",96,58,64,59,42,36,52,64,62,4,52,59,67,89,58,70,43,56,63,70,74,7,100,100,64,67,20,49,58,42,25,51,39,71,63,100,44,55,28,51,19,38,66,7,49,68,58,69,59,75,47,38,46,62,16,29,23,"1","1",36,60,49,52,47,15,47,63,50,72,10,68,15,7,45,55,55,52,100,100,38,26,51,91,60,52,29,75,83,100,56,64,80,"0",52,78,56,31,7,100,"0","4",20,3,52,"0",63,67,63,49,62,5,76,100,56,"0","1",100,90,64,3,"11",38
"2008-06-01",51,50,0,89,37,52,29,29,39,70,68,82,0,62,36,28,15,10,43,4,70,64,47,"1",11,20,15,47,45,76,79,74,89,100,73,10,79,34,33,78,78,24,0,35,58,61,55,90,74,71,60,58,46,33,40,42,67,53,76,22,64,47,72,47,41,48,60,80,75,49,50,64,60,65,23,100,"13",83,79,100,100,100,100,100,85,25,21,59,0,97,28,15,75,32,5,1,"0","<1","<1",7,7,13,"1","1",0,"0",24,2,60,"<1",13,64,51,79,60,79,70,70,63,52,2,8,"53",100,70,52,52,45,25,49,29,57,4,47,50,73,87,72,39,58,36,64,66,70,8,69,58,58,65,60,45,65,21,26,43,34,63,48,54,63,42,20,38,19,55,60,8,39,72,53,65,65,78,81,48,43,55,18,51,32,"1","1",33,64,55,54,56,11,53,65,58,84,14,37,17,8,52,64,89,87,46,51,54,28,48,95,60,43,26,98,40,95,65,69,65,"0",100,82,58,22,8,91,"2","3",17,2,49,"0",43,75,68,57,63,5,79,81,51,"<1","1",57,54,58,7,"12",50
"2008-07-01",51,54,0,60,50,46,22,22,53,49,100,83,0,50,34,43,9,9,48,5,69,59,52,"<1",5,19,6,86,59,71,82,76,85,91,75,17,61,25,51,69,82,24,0,41,61,68,54,66,50,63,61,59,43,35,41,33,68,47,71,26,54,36,73,51,39,52,64,78,61,32,37,81,46,42,8,0,"14",61,65,88,80,93,78,89,55,29,10,43,0,96,34,27,83,31,0,1,"0","0","<1",6,4,13,"1","1",0,"0",24,3,50,"<1",14,23,43,75,53,65,64,66,67,60,8,9,"35",66,70,34,48,47,21,44,37,58,3,58,42,70,87,46,67,68,31,63,69,63,10,49,57,55,66,68,38,49,26,28,100,34,75,56,44,58,37,41,59,18,39,54,6,44,58,57,55,49,72,57,39,37,41,18,36,31,"1","1",31,65,62,63,65,15,42,66,59,82,12,57,18,7,54,68,62,79,14,27,67,29,71,89,61,43,37,65,42,68,65,71,100,"0",74,83,65,23,7,50,"1","0",17,2,44,"2",56,74,71,54,71,37,55,62,54,"1","0",46,16,51,3,"12",39
"2008-08-01",51,52,0,60,27,46,19,38,48,57,51,73,0,48,29,40,11,12,26,4,64,54,49,"1",8,19,18,53,39,75,70,76,83,80,71,8,58,49,32,72,75,30,3,31,66,19,50,46,37,39,61,52,39,30,39,40,56,51,75,20,52,44,71,51,31,44,60,75,30,21,22,0,42,37,7,21,"14",66,34,68,53,74,61,67,34,20,0,44,0,74,43,22,82,32,0,1,"0","0","<1",6,4,13,"1","0",0,"0",23,2,48,"0",13,20,51,52,53,58,61,62,60,47,0,4,"15",50,54,37,45,43,21,42,37,51,2,100,53,72,83,62,61,71,33,54,64,52,9,24,28,58,63,37,37,55,32,28,51,36,77,64,24,32,39,30,36,15,30,66,6,49,57,48,33,53,74,42,32,22,38,23,50,77,"1","0",34,54,43,52,53,16,43,52,47,76,8,34,17,5,38,61,62,46,0,22,51,28,47,74,59,32,25,65,45,44,65,74,79,"0",76,81,56,21,0,29,"0","0",16,0,42,"0",61,76,41,37,70,5,57,22,55,"0","1",39,16,45,6,"12",51
"2008-09-01",59,42,4,61,30,44,31,24,45,62,31,87,0,27,49,34,15,11,54,5,70,76,47,"1",16,23,20,100,63,28,56,70,76,62,64,5,43,56,36,75,80,22,3,43,62,54,66,42,21,28,63,53,64,63,52,33,53,58,28,21,60,73,81,43,33,43,74,74,38,32,25,38,50,45,12,39,"15",55,55,60,49,62,58,65,48,31,0,53,39,57,65,21,59,52,0,1,"0","0","<1",15,9,21,"3","3",0,"0",26,4,79,"<1",18,25,57,54,33,46,70,41,74,59,2,5,"14",35,43,29,56,71,43,47,43,67,3,57,61,72,90,46,28,100,55,72,66,73,7,28,30,70,68,57,43,48,38,26,60,43,78,58,23,33,57,30,37,21,34,86,11,35,60,69,46,64,72,45,46,56,64,13,41,14,"3","2",49,71,32,46,48,13,61,62,51,63,8,25,19,11,38,56,43,34,27,15,34,26,85,98,64,51,18,78,23,34,51,70,55,"0",56,79,57,59,5,30,"1","4",26,3,54,"0",67,88,40,70,68,15,52,47,52,"<1","1",36,35,46,3,"12",44
"2008-10-01",58,33,3,63,21,73,16,34,22,49,64,90,0,44,45,53,15,7,28,4,78,81,39,"1",10,22,8,31,56,32,56,57,79,80,59,8,29,56,27,76,88,23,2,69,62,80,69,38,37,30,62,61,59,62,51,25,46,54,32,23,71,58,79,45,38,46,78,70,52,48,25,0,53,49,17,53,"14",32,29,51,43,50,39,60,43,21,35,53,35,52,69,17,56,51,0,1,"0","0","<1",29,9,40,"2","4",0,"0",30,5,83,"<1",11,42,52,58,28,27,66,44,67,64,3,4,"16",49,30,60,61,68,47,54,31,75,5,52,53,72,74,48,31,87,62,66,61,41,15,30,29,58,69,17,38,48,50,24,63,39,84,60,23,35,62,29,37,23,38,63,10,33,58,68,48,65,72,52,50,13,45,18,52,13,"2","3",53,77,47,39,41,15,67,60,46,75,13,20,16,4,33,51,40,33,49,20,43,23,56,50,69,49,15,75,38,24,54,70,47,"0",33,78,54,59,16,61,"2","4",31,3,61,"0",77,83,52,56,67,21,55,20,53,"1","3",46,25,54,5,"11",65
"2008-11-01",65,35,0,48,28,57,16,19,30,57,25,78,0,28,51,41,3,7,34,3,67,66,36,"1",16,21,9,15,36,33,54,68,80,43,57,16,41,28,36,68,75,16,0,43,57,18,64,39,35,23,60,61,52,62,42,26,43,51,33,17,64,66,76,25,39,53,71,70,38,41,33,38,53,56,22,30,"11",47,29,41,36,42,35,48,32,22,19,68,20,55,61,18,49,52,0,1,"0","<1","<1",21,7,25,"2","3",0,"0",26,3,73,"<1",24,41,50,22,36,39,76,41,67,56,6,5,"20",30,32,32,58,42,36,49,17,57,2,39,20,67,71,44,25,38,57,56,60,32,6,24,20,62,64,19,41,50,52,23,46,35,60,54,38,23,53,32,39,17,23,64,8,37,63,61,33,55,61,35,43,18,27,14,36,29,"2","2",50,69,38,41,33,7,49,57,40,68,12,26,14,14,43,53,45,50,14,32,32,22,43,40,57,44,18,57,20,28,62,66,38,"0",56,76,45,50,5,44,"1","1",29,4,56,"0",60,66,35,47,76,15,65,15,45,"<1","1",22,23,50,5,"11",24
"2008-12-01",51,43,0,62,23,76,23,19,20,25,37,74,0,33,39,21,10,11,18,5,59,60,36,"1",6,19,16,22,39,43,59,75,84,42,58,13,29,25,41,63,67,21,3,42,51,18,55,30,27,18,58,44,41,44,44,27,43,47,43,18,54,47,86,26,15,37,61,75,74,29,15,0,48,43,10,39,"13",51,40,45,44,33,26,40,26,15,0,53,38,49,64,17,54,43,8,1,"1","0","<1",17,4,14,"1","1",0,"0",22,3,61,"<1",18,31,40,21,20,38,72,48,57,52,4,6,"9",34,34,28,57,35,21,43,25,53,4,28,14,69,71,38,34,15,53,59,64,61,10,16,9,50,57,15,45,44,25,23,78,19,56,58,20,19,40,34,27,12,38,51,8,34,51,53,23,57,57,46,39,31,21,14,27,0,"1","1",58,62,25,40,39,13,45,62,41,75,10,21,15,4,43,61,53,45,13,16,35,21,28,43,58,39,16,39,13,22,56,68,40,"0",44,70,49,44,3,26,"1","2",21,4,45,"0",45,49,20,30,71,17,32,13,36,"<1","1",43,22,34,6,"13",16
"2009-01-01",59,46,0,51,6,39,21,18,23,12,35,78,0,33,31,17,5,10,19,7,71,64,36,"1",14,26,19,0,44,44,65,82,90,48,70,6,41,11,39,76,81,25,3,36,79,0,56,36,21,23,67,49,59,50,39,31,63,52,44,28,61,49,88,42,9,47,70,73,26,23,19,0,52,42,11,27,"19",47,27,33,25,37,21,42,24,19,0,48,36,51,100,32,49,38,0,1,"0","0","<1",5,9,16,"0","0",0,"0",25,4,63,"<1",16,17,56,10,29,33,77,59,63,59,4,7,"13",29,28,35,57,41,32,39,32,45,4,46,21,85,87,66,35,22,51,67,62,51,10,15,12,60,67,23,35,42,33,28,31,16,60,74,16,29,48,36,29,22,29,67,10,29,65,72,26,75,72,67,43,27,20,15,40,0,"0","0",66,56,27,43,32,19,46,61,49,84,7,26,22,10,48,71,75,73,0,5,27,30,24,45,66,43,25,59,15,27,47,92,46,"0",83,95,73,37,5,28,"1","2",20,2,47,"2",50,61,22,57,95,14,36,14,59,"<1","3",34,23,50,10,"14",11
"2009-02-01",71,52,0,61,20,60,25,19,15,16,39,84,0,44,55,12,12,12,22,6,74,82,39,"2",14,24,20,8,49,25,63,83,89,35,70,12,35,18,44,81,87,29,5,51,52,27,70,31,27,23,66,47,60,61,45,21,60,58,25,23,76,64,87,52,19,53,82,69,47,29,22,19,55,46,13,39,"20",51,32,34,21,40,19,44,25,24,9,39,19,58,91,10,55,53,8,2,"1","1","1",14,7,18,"2","1",3,"0",27,9,72,"<1",15,21,57,21,32,33,67,64,64,66,7,7,"12",22,24,62,61,76,38,51,42,58,5,54,15,69,93,60,19,18,59,80,64,68,12,19,16,58,70,19,61,49,42,28,43,25,63,69,17,15,54,32,34,21,30,82,10,33,65,74,20,69,67,73,43,26,27,17,28,0,"2","1",63,67,28,35,43,13,46,67,44,69,16,22,22,11,64,71,52,76,0,12,33,32,32,38,52,50,14,64,22,24,62,77,41,"1",68,98,64,57,8,36,"1","5",23,4,60,"2",43,62,17,34,73,10,54,11,67,"1","3",56,17,57,8,"15",24
"2009-03-01",58,41,3,58,26,59,23,21,9,18,16,86,0,45,47,11,21,8,19,6,70,77,44,"1",9,24,11,0,38,28,74,76,90,33,53,12,37,22,36,76,82,36,2,46,62,0,67,30,24,22,64,39,58,52,44,17,67,50,28,30,62,57,86,55,15,52,76,65,50,28,12,17,56,48,17,35,"18",34,24,33,29,40,25,45,20,9,17,63,17,45,75,22,56,46,4,1,"0","<1","<1",8,8,19,"2","1",0,"0",27,5,71,"<1",25,19,56,47,22,32,74,77,62,53,7,7,"19",31,27,48,63,55,43,37,46,55,6,36,19,75,89,33,33,9,56,79,63,33,15,19,11,56,67,25,33,54,35,29,42,10,58,70,24,12,58,30,31,17,34,67,11,43,66,74,24,76,70,79,43,8,21,15,33,0,"2","1",69,60,18,34,52,11,48,67,52,95,14,27,23,4,57,80,59,70,24,12,19,37,49,37,63,54,20,79,23,17,35,80,44,"0",81,93,52,50,5,24,"1","7",25,5,61,"3",41,65,13,37,84,6,44,13,60,"1","1",26,24,41,5,"15",11
"2009-04-01",60,42,3,54,13,86,33,32,23,13,28,81,0,42,45,6,20,12,19,7,69,75,42,"1",21,23,18,14,35,29,65,73,83,29,97,9,35,31,51,75,76,32,2,62,49,0,66,34,27,18,66,37,60,53,41,30,63,60,29,31,59,55,87,41,24,53,78,67,43,31,19,0,53,45,10,18,"18",53,43,29,21,36,27,41,22,12,17,63,18,53,71,23,41,50,0,1,"0","0","<1",11,19,19,"1","2",0,"2",27,4,75,"<1",29,11,56,29,13,37,63,68,57,52,12,4,"11",39,18,23,59,59,40,38,0,63,7,59,17,66,77,43,23,7,64,67,60,41,7,15,16,54,68,34,32,45,34,30,31,22,55,76,14,24,50,38,34,23,31,63,10,27,60,67,21,72,57,57,48,21,26,19,22,0,"1","2",67,54,44,32,26,13,53,68,47,77,12,31,23,12,62,74,70,68,0,12,24,38,25,43,66,53,20,47,24,19,55,81,38,"0",76,90,64,49,6,33,"1","6",24,5,65,"1",47,66,19,42,80,10,38,14,72,"2","1",46,25,63,4,"15",22
"2009-05-01",61,34,0,48,13,55,14,17,22,18,32,74,0,55,36,0,17,14,18,7,63,61,43,"1",24,21,20,0,31,29,71,77,86,40,67,13,36,12,35,64,68,20,4,47,54,24,56,34,26,30,59,39,49,39,43,16,63,44,29,32,59,48,82,41,12,59,68,63,17,24,9,34,51,45,8,18,"20",44,43,35,28,43,38,52,21,7,9,51,0,44,83,7,54,45,8,1,"0","<1","<1",13,11,17,"3","0",0,"2",25,4,56,"<1",22,11,51,48,25,39,61,84,47,45,3,7,"21",20,24,21,52,50,30,29,16,44,7,40,15,65,76,30,34,8,49,57,63,28,12,14,9,55,63,20,29,44,30,31,38,13,53,72,9,27,47,38,32,18,28,59,8,18,60,58,14,79,64,62,30,16,61,17,30,13,"3","<1",72,49,21,28,27,11,44,51,48,87,10,38,24,6,67,83,71,62,0,3,24,37,31,32,71,47,19,38,18,29,47,85,36,"1",71,89,69,39,6,15,"1","7",21,8,52,"0",41,48,19,45,78,15,36,14,85,"2","1",66,13,51,6,"16",11
"2009-06-01",58,28,3,43,28,36,9,18,18,17,35,81,0,67,35,6,19,14,19,7,64,55,37,"1",32,31,8,7,24,35,90,79,94,28,73,16,50,19,33,67,73,31,5,34,48,0,49,45,42,34,61,28,51,35,33,14,72,47,35,33,54,42,87,33,16,63,73,65,35,12,7,0,49,35,5,18,"23",41,30,39,32,56,47,66,22,13,0,44,36,39,93,23,44,33,8,2,"0","1","1",13,17,26,"7","3",4,"3",30,5,62,"1",24,12,49,15,19,48,73,93,44,42,5,7,"7",16,20,37,49,32,29,28,0,42,10,62,26,88,92,52,29,12,36,68,62,35,15,12,9,50,67,6,28,31,41,35,35,18,59,73,19,32,33,24,43,23,26,47,14,20,70,65,15,76,88,90,34,19,22,18,24,0,"7","3",80,45,24,25,28,11,30,50,45,87,13,22,25,8,69,95,91,83,0,3,16,39,24,44,72,38,27,41,15,35,63,92,45,"2",77,92,79,21,10,22,"1","4",25,10,58,"3",25,45,14,28,92,32,39,21,100,"2","3",47,18,51,7,"14",15
"2009-07-01",49,34,28,37,27,35,19,12,23,12,28,75,17,90,25,11,17,8,20,7,64,52,35,"10",69,33,13,7,25,41,88,84,100,32,55,14,52,21,35,66,68,30,14,35,41,16,48,41,37,39,62,50,47,30,29,19,82,46,41,31,55,38,88,33,21,65,60,65,34,13,11,17,42,32,6,0,"23",41,49,46,28,56,41,63,25,11,9,33,80,37,100,27,43,31,29,11,"8","12","10",16,53,63,"23","8",9,"10",41,16,68,"7",32,11,47,19,15,48,78,100,42,41,5,10,"8",18,18,29,47,57,29,33,31,36,21,49,37,85,99,37,26,4,29,71,59,41,13,7,8,47,63,26,30,32,27,36,25,20,63,96,14,27,28,27,32,32,9,50,22,30,61,62,12,92,78,100,32,21,16,21,22,0,"23","8",84,44,29,28,19,12,35,44,47,100,10,32,27,8,79,96,88,100,0,9,24,38,29,41,83,36,16,51,0,39,55,95,50,"15",83,95,78,26,45,9,"16","32",44,29,67,"23",37,47,14,56,94,48,57,17,96,"8","7",20,7,55,11,"14",22
"2009-08-01",53,31,58,36,10,45,14,9,32,13,39,75,61,76,27,11,12,8,24,9,63,52,35,"21",90,47,15,0,32,42,83,96,96,37,66,12,58,35,16,70,66,26,29,27,53,16,50,46,19,39,58,50,51,27,33,21,75,47,42,34,50,41,93,26,16,63,60,64,0,12,5,0,40,31,9,0,"23",42,28,37,30,52,35,58,27,6,9,26,80,38,94,21,52,29,32,22,"17","29","20",53,75,94,"34","34",18,"28",57,19,69,"20",42,14,52,58,18,45,75,85,41,33,10,9,"5",11,22,26,42,36,24,30,16,35,43,35,30,76,87,59,28,15,32,73,61,41,17,9,6,51,63,17,21,31,28,37,38,13,53,100,16,24,31,25,37,45,28,44,39,33,59,61,15,75,80,67,31,8,26,20,26,0,"34","31",82,39,29,26,28,11,29,39,47,95,7,38,25,12,70,92,61,71,0,6,39,39,29,36,70,31,13,49,6,37,43,100,49,"34",44,94,77,24,36,18,"26","55",69,52,82,"29",37,39,9,28,100,83,58,12,79,"15","19",46,9,38,11,"15",14
"2009-09-01",57,36,50,40,14,56,18,18,17,24,27,79,100,49,47,5,13,8,28,7,67,77,36,"8",45,42,21,0,20,32,71,76,88,31,71,17,35,34,21,69,74,39,33,39,47,15,65,41,25,29,61,40,58,42,45,8,53,53,32,30,59,53,86,25,15,70,73,59,0,14,12,16,48,41,7,34,"20",47,28,37,27,47,32,46,16,6,0,50,34,28,100,20,50,42,4,9,"5","7","7",43,34,67,"33","29",10,"15",50,13,68,"8",37,11,57,28,19,29,73,64,45,35,2,6,"12",25,18,17,57,50,36,32,15,54,33,16,18,71,84,37,22,18,52,76,60,33,17,15,6,59,67,16,31,32,27,35,31,16,62,79,9,26,54,28,32,32,16,80,37,29,65,67,12,74,70,57,44,5,16,21,28,25,"33","28",84,51,30,30,25,7,44,50,43,81,11,21,22,12,44,64,63,38,0,3,25,35,35,28,81,46,19,39,8,26,45,91,45,"11",64,92,65,49,21,17,"8","30",60,35,79,"10",36,47,22,57,85,57,51,15,74,"16","26",32,22,37,11,"14",17
"2009-10-01",63,34,33,56,23,63,42,45,8,21,41,80,31,51,33,5,8,14,18,8,65,80,34,"8",29,35,22,0,26,28,66,68,88,38,67,13,33,30,39,70,78,19,44,55,63,7,70,40,22,26,62,42,55,46,36,26,52,53,28,27,60,49,84,25,11,55,71,56,16,19,15,0,44,39,8,16,"18",29,29,36,24,45,34,51,17,15,8,49,80,36,94,16,46,46,3,9,"8","9","7",38,24,43,"23","14",9,"21",40,14,73,"8",38,13,50,31,13,28,72,59,43,35,6,14,"16",30,21,19,61,37,40,37,14,57,29,32,33,85,82,37,39,7,57,76,56,56,19,21,4,51,65,20,28,32,30,33,39,17,61,74,8,14,45,30,41,29,25,63,26,19,71,67,15,78,76,49,65,5,14,20,29,0,"23","13",87,53,16,23,16,10,57,54,37,96,8,25,21,22,41,59,50,43,0,5,20,33,15,36,74,52,25,52,5,28,53,88,41,"10",40,86,70,47,21,19,"15","25",44,36,72,"15",38,54,13,41,79,37,57,8,62,"15","25",24,16,47,8,"13",13
"2009-11-01",62,24,52,51,35,61,41,22,17,15,33,75,81,51,43,8,20,9,19,5,63,69,32,"25",45,42,19,0,25,33,62,66,84,36,48,12,39,35,35,65,72,34,62,50,53,0,63,38,24,28,57,34,52,59,38,12,48,50,33,18,54,54,83,24,13,66,72,60,40,24,13,0,58,45,10,16,"18",62,19,38,28,47,34,48,18,16,16,64,41,42,91,23,41,43,18,25,"23","25","25",34,45,46,"23","21",12,"24",49,28,69,"22",39,19,51,32,9,41,65,50,42,33,3,12,"14",30,15,29,60,51,36,34,29,55,34,31,17,73,90,32,45,13,61,69,55,35,15,12,10,48,62,16,23,37,39,28,30,23,60,80,13,21,47,19,30,40,15,59,36,30,68,62,17,70,68,55,38,24,18,15,27,12,"23","21",88,47,19,24,14,4,50,47,34,86,13,26,19,6,44,60,47,46,0,4,16,30,20,26,65,43,11,56,11,26,57,83,41,"18",47,84,66,52,45,20,"41","52",63,53,83,"34",48,57,27,36,80,65,42,21,53,"22","33",24,17,30,6,"12",20
"2009-12-01",51,28,20,49,50,50,30,23,8,40,29,67,24,47,36,10,7,19,16,6,54,60,31,"18",39,38,14,0,18,28,66,69,86,37,62,19,30,46,37,57,67,23,55,37,36,0,56,39,31,28,54,35,42,45,27,18,45,40,28,20,60,45,90,24,5,53,58,66,24,21,7,16,48,38,8,0,"16",46,30,46,40,51,28,52,15,10,16,49,57,33,86,21,37,39,21,19,"15","20","18",29,33,33,"24","21",13,"18",39,23,60,"16",27,16,42,9,14,40,63,61,30,29,9,9,"16",25,31,48,48,51,26,26,43,53,30,30,6,58,68,25,31,15,50,61,54,32,5,12,7,46,53,8,18,30,25,30,31,13,60,71,4,23,38,38,29,30,19,56,27,37,48,52,16,59,70,49,40,12,16,16,34,0,"24","22",93,45,33,27,24,10,39,45,42,93,11,24,18,6,51,62,52,53,0,7,20,28,25,52,51,37,12,51,5,26,61,75,42,"15",36,76,54,32,22,20,"24","38",44,35,63,"16",49,50,16,26,71,21,29,16,53,"22","23",12,8,39,4,"12",7
"2010-01-01",60,42,16,45,27,50,34,21,39,24,34,75,45,49,33,0,20,16,23,7,63,59,37,"9",35,32,16,0,26,33,73,88,89,32,60,12,34,39,48,65,75,37,26,41,52,14,58,45,41,25,60,41,56,43,36,20,68,53,33,31,65,43,85,34,19,59,62,65,59,20,21,15,49,35,13,31,"23",40,30,39,26,55,34,58,18,11,15,44,30,39,94,24,55,41,13,9,"7","5","9",23,29,27,"16","19",8,"16",34,14,62,"8",24,10,52,29,21,28,88,64,46,43,9,10,"12",16,20,40,50,46,32,36,13,43,19,36,30,81,92,40,24,12,48,73,55,46,16,12,9,55,61,7,26,35,25,34,31,25,53,89,12,15,40,17,16,23,10,55,19,34,54,67,13,75,81,68,29,18,14,20,21,0,"16","13",100,46,33,35,47,11,40,47,46,94,12,26,25,11,49,75,72,75,0,5,17,37,23,32,72,42,10,53,30,35,38,96,46,"6",30,98,78,38,17,18,"14","27",31,23,57,"20",43,50,14,51,84,20,50,15,80,"13","17",45,8,37,8,"13",9
"2010-02-01",65,55,9,55,30,51,23,24,8,15,20,78,31,42,38,15,22,19,21,7,63,75,33,"5",25,28,21,0,21,25,70,87,88,37,64,23,43,26,45,68,75,27,31,58,48,0,67,38,36,38,63,34,53,49,31,14,67,51,25,33,69,54,86,21,18,63,76,72,15,18,8,15,47,40,10,32,"22",42,30,35,20,42,27,51,18,14,23,54,62,27,80,15,53,48,8,5,"5","4","4",33,19,32,"17","14",11,"15",32,7,61,"5",22,18,53,30,62,31,59,68,50,38,6,5,"6",12,22,21,53,44,37,26,14,55,17,48,13,65,81,36,33,8,53,76,55,44,11,15,8,51,63,23,18,30,33,34,30,32,61,71,14,18,42,32,30,19,19,67,19,31,69,61,14,73,72,89,42,12,32,20,27,23,"17","13",92,46,41,38,47,12,46,44,40,87,8,24,26,4,55,74,74,63,0,7,19,40,31,29,58,51,24,49,13,34,46,84,40,"4",35,94,59,48,15,19,"5","16",32,17,59,"4",43,61,14,77,72,15,31,15,80,"9","16",29,18,31,8,"13",19
"2010-03-01",67,52,100,45,31,57,30,24,22,23,36,81,77,71,32,4,18,23,21,8,68,72,34,"100",100,100,20,0,30,37,75,85,87,41,66,9,44,27,59,67,78,42,100,52,57,7,65,36,32,30,61,38,58,47,43,18,70,47,37,28,69,62,87,26,6,65,76,67,21,19,20,14,49,43,10,14,"27",39,42,35,22,50,29,54,17,12,7,55,100,31,90,27,56,48,100,100,"100","100","100",100,100,100,"100","100",100,"100",100,100,74,"100",100,18,58,12,53,32,72,79,47,37,8,11,"7",23,19,15,59,61,45,39,25,59,100,40,16,68,88,44,30,12,54,75,58,79,12,20,7,50,64,21,16,29,39,37,33,15,59,70,17,19,42,29,30,100,17,56,100,36,59,73,20,72,85,89,43,13,28,23,33,0,"100","100",99,48,53,31,46,15,59,49,41,88,7,32,27,21,50,72,74,45,0,5,33,42,21,39,55,58,13,29,21,29,71,82,43,"100",43,100,68,44,100,17,"100","100",100,100,100,"100",47,64,21,48,78,100,27,11,86,"100","100",21,27,41,7,"14",18
"2010-04-01",67,44,29,52,32,75,38,26,8,25,32,80,37,65,49,0,17,8,26,8,67,73,38,"18",57,35,23,0,22,30,75,73,84,34,59,12,41,32,41,76,74,42,25,58,47,0,67,36,33,27,61,37,54,46,38,11,71,52,30,29,56,58,88,31,10,54,79,66,15,21,28,0,55,46,8,23,"28",34,25,39,20,51,30,54,22,15,15,61,53,35,75,27,57,66,15,18,"22","17","18",29,48,38,"14","10",18,"14",39,35,68,"20",31,12,56,25,37,43,75,73,47,37,13,10,"18",35,16,15,59,54,42,38,13,57,51,44,18,87,93,41,24,8,55,68,57,45,13,15,15,51,68,29,24,29,36,39,24,29,51,70,14,15,49,32,30,43,24,60,24,30,64,62,22,84,72,80,43,16,25,21,27,0,"14","12",97,43,64,30,25,10,63,52,41,92,22,38,30,17,55,81,65,51,0,10,31,44,25,30,51,50,23,52,20,33,63,86,37,"19",44,96,77,53,29,15,"19","38",37,35,64,"21",46,58,17,33,73,31,45,22,90,"22","33",45,15,32,6,"13",15
"2010-05-01",47,44,6,89,20,56,12,20,8,10,28,74,15,62,43,10,27,12,17,9,59,60,34,"7",35,23,13,0,14,37,84,76,86,69,63,18,36,44,42,64,72,38,13,46,50,7,53,36,38,33,56,39,53,38,35,18,71,42,37,28,52,54,83,22,21,66,67,67,0,17,26,0,50,48,8,0,"28",43,26,38,23,51,28,51,18,8,7,39,16,35,70,14,61,37,3,6,"5","7","6",18,24,21,"5","3",10,"3",28,16,56,"7",24,7,49,8,39,29,60,79,36,37,10,17,"11",18,20,36,53,31,28,29,14,44,28,31,25,86,88,39,30,9,50,65,49,49,15,9,8,51,62,10,20,25,30,40,31,39,53,69,8,12,43,33,41,17,22,57,13,25,59,65,25,82,68,79,37,7,27,25,34,0,"5","5",96,39,32,28,12,7,46,46,37,84,7,26,30,20,56,77,79,51,0,8,17,40,17,35,65,44,23,50,36,35,79,86,44,"7",42,92,81,43,16,24,"10","13",25,17,47,"10",33,46,18,58,82,14,20,18,100,"8","7",17,30,46,12,"14",6
"2010-06-01",49,35,4,100,23,45,13,13,20,21,24,75,31,99,30,5,15,15,13,9,58,52,36,"5",35,21,11,12,18,24,92,75,90,52,58,19,46,43,41,69,64,37,10,29,48,7,52,36,35,30,56,37,50,32,25,22,70,40,24,28,50,44,93,25,9,63,61,68,0,12,11,0,48,34,6,24,"28",30,32,41,24,48,32,52,20,12,8,35,16,51,58,22,47,37,7,5,"5","5","4",7,16,20,"6","3",6,"6",27,14,51,"5",11,10,44,13,38,46,72,98,42,32,17,13,"9",14,26,33,45,23,31,25,0,33,26,30,17,93,100,38,36,8,33,63,54,60,16,14,11,50,65,16,18,24,26,43,24,33,56,72,12,23,34,35,33,18,17,46,9,25,57,52,22,74,80,76,38,7,25,24,21,0,"6","2",92,37,38,27,22,13,33,36,37,91,10,21,31,22,69,89,100,78,22,5,30,42,21,51,70,35,24,32,29,36,53,97,43,"3",58,97,100,31,10,16,"4","10",20,13,49,"5",33,41,23,53,74,16,45,15,95,"7","5",12,25,29,8,"14",26
"2010-07-01",45,38,6,57,21,30,14,18,21,13,17,65,40,95,22,6,14,16,19,12,53,45,32,"4",15,19,17,5,14,29,93,77,86,27,70,19,39,18,31,60,60,33,6,24,45,6,44,39,34,31,48,49,36,21,19,9,71,33,29,32,49,34,90,28,11,54,50,65,26,9,9,13,38,27,7,14,"30",35,21,41,22,50,37,53,12,7,0,32,14,44,54,18,48,22,3,4,"1","4","4",10,13,16,"4","1",4,"4",23,12,48,"4",16,4,34,19,52,43,60,92,34,27,9,19,"7",15,19,26,39,40,24,27,12,34,23,23,19,85,83,31,39,6,26,57,54,50,21,11,12,47,51,9,16,27,29,44,28,40,58,66,5,23,24,28,38,15,13,45,9,27,47,52,13,81,78,87,28,16,30,28,35,0,"4","1",88,30,38,28,17,9,29,31,33,90,12,22,33,20,61,85,92,74,9,2,28,39,29,45,65,30,11,44,20,40,44,90,45,"5",37,86,77,17,7,12,"4","10",16,8,41,"2",26,33,7,21,71,19,40,9,75,"3","4",20,14,16,11,"14",28
"2010-08-01",42,42,2,46,19,39,15,19,27,18,39,67,0,90,26,8,9,20,26,10,51,45,32,"3",17,22,29,8,9,32,81,79,84,34,53,12,39,22,32,61,59,31,6,38,47,18,43,31,31,31,49,41,40,27,24,12,56,36,32,29,46,35,88,18,13,46,49,66,13,9,15,13,44,31,7,20,"29",52,32,35,24,42,31,48,14,6,0,35,0,43,60,30,64,27,4,4,"5","2","3",10,12,16,"3","3",4,"5",24,9,46,"3",11,8,42,14,38,34,62,75,41,32,19,13,"4",18,27,25,39,37,16,21,12,30,18,36,10,77,81,38,21,6,25,54,57,69,19,15,11,50,53,21,19,27,15,40,42,30,55,77,14,24,26,36,38,20,19,45,7,22,55,48,12,86,81,74,23,12,31,26,33,0,"3","3",78,31,42,33,17,14,26,32,35,83,7,18,31,21,50,80,63,44,0,2,29,40,39,44,80,31,13,44,35,31,54,85,35,"1",38,84,75,18,7,13,"2","6",17,9,43,"3",23,31,11,49,76,9,32,8,76,"2","4",19,15,24,12,"15",19
"2010-09-01",49,38,9,53,13,40,30,19,16,8,33,66,12,56,47,10,19,19,15,11,55,66,28,"5",29,25,14,5,23,22,68,63,74,25,66,18,35,37,34,66,67,35,14,34,56,11,63,32,23,26,56,42,47,47,31,9,48,42,22,26,56,44,84,17,10,40,62,63,25,17,15,0,43,31,7,26,"27",43,21,36,21,40,30,48,13,12,0,43,12,38,46,23,43,39,3,5,"2","3","4",11,19,20,"7","5",3,"6",26,14,56,"5",17,6,45,7,24,34,62,57,36,26,18,12,"11",12,18,32,47,41,34,31,0,47,24,35,15,74,71,28,18,7,41,54,51,40,14,10,8,56,55,8,19,31,29,41,36,32,66,61,16,13,40,23,36,24,13,62,14,29,55,62,16,74,68,46,43,15,26,24,24,0,"7","4",73,35,35,32,28,11,43,40,31,67,18,17,30,15,42,63,44,37,9,5,23,35,27,37,65,31,20,26,40,32,59,79,33,"3",34,81,61,42,10,13,"4","16",23,11,48,"7",37,44,12,43,71,18,31,11,65,"6","6",19,11,20,12,"15",39
"2010-10-01",48,36,12,45,20,51,16,18,12,15,37,67,18,52,33,6,13,15,12,10,53,66,27,"5",25,23,23,10,17,30,65,55,73,35,57,18,32,33,24,64,66,28,17,38,55,0,60,29,28,27,53,40,46,43,28,18,46,42,30,25,53,43,83,19,17,44,66,59,12,15,19,0,42,35,6,25,"27",71,18,37,20,48,32,47,13,8,0,43,12,36,46,18,37,46,8,5,"5","5","5",9,21,22,"5","2",7,"2",26,12,55,"5",17,10,43,20,33,30,59,47,32,28,11,10,"15",16,18,39,47,40,38,31,0,47,27,34,13,73,54,29,26,4,44,55,52,54,19,15,6,50,55,22,17,27,32,38,32,27,58,63,8,9,41,25,31,21,14,54,11,19,58,57,14,71,62,49,35,13,34,22,28,0,"5","3",74,40,36,24,11,16,51,43,30,70,7,30,29,14,38,51,32,37,8,6,34,34,33,38,50,39,13,41,35,29,66,70,36,"3",34,76,50,39,13,13,"4","14",22,12,48,"5",47,46,15,38,64,16,17,7,57,"8","10",22,14,24,11,"15",15
"2010-11-01",53,43,16,44,20,57,19,20,9,13,35,64,0,42,37,0,19,12,15,11,53,59,25,"5",21,21,13,5,12,27,56,54,73,38,52,16,32,20,28,59,65,32,16,33,36,0,59,36,28,27,52,35,49,49,33,16,39,43,27,25,64,48,85,13,10,52,58,61,36,18,100,12,56,47,13,25,"27",95,29,37,26,43,27,49,13,6,0,53,37,38,43,21,51,39,3,5,"4","4","4",16,17,22,"4","6",2,"4",26,12,58,"6",17,14,40,20,45,35,54,44,39,27,19,14,"11",16,20,41,49,33,39,31,21,48,23,49,21,69,67,21,16,7,47,53,45,46,21,10,10,46,54,22,13,23,32,33,40,38,50,61,10,17,36,42,39,23,18,50,10,20,51,51,13,74,63,53,29,11,26,24,25,0,"4","5",72,39,18,26,21,9,51,41,29,70,10,23,27,8,34,49,39,41,34,22,21,30,26,36,55,37,12,47,16,31,66,68,38,"1",40,78,45,44,12,48,"7","15",26,18,52,"0",42,66,11,44,62,19,17,14,44,"7","13",14,19,23,8,"14",28
"2010-12-01",47,30,9,41,16,40,19,18,6,10,46,58,48,48,24,4,12,12,16,10,45,50,25,"3",8,19,15,5,14,35,58,54,72,36,46,17,34,16,42,51,60,20,12,33,39,17,49,34,32,27,45,40,39,42,25,6,41,39,35,23,48,32,88,16,20,42,49,63,36,12,38,0,49,34,7,18,"26",98,41,48,35,44,25,49,13,5,18,41,18,41,34,22,42,43,5,3,"2","2","3",16,8,14,"2","1",3,"2",21,6,45,"3",13,17,31,27,40,39,52,46,32,29,12,10,"8",12,32,50,39,39,28,26,27,40,17,43,17,63,55,27,29,3,38,49,48,30,12,10,9,42,45,12,12,23,24,35,23,26,52,52,9,17,33,37,47,12,8,43,9,22,41,48,12,64,69,46,28,16,24,23,26,9,"2","1",65,36,25,26,24,14,37,33,25,73,11,17,27,6,30,47,42,53,0,19,27,31,16,55,46,30,17,41,28,32,35,62,39,"1",36,70,42,30,5,15,"3","10",15,11,38,"3",36,44,8,57,61,12,34,7,40,"5","5",9,12,24,12,"13",12
"2011-01-01",52,53,14,51,17,40,34,21,7,19,27,67,19,44,25,6,18,19,29,14,60,55,32,"5",26,29,25,0,17,50,78,77,91,48,75,20,49,30,35,65,66,42,16,38,72,0,57,42,54,37,59,50,46,40,29,12,71,44,50,36,72,36,100,23,18,51,60,78,19,18,77,19,58,53,19,0,"42",75,30,52,28,60,37,62,22,8,33,47,19,39,61,30,52,33,6,5,"3","5","5",10,16,20,"7","4",3,"6",28,9,60,"5",17,34,48,32,39,44,71,61,42,39,15,16,"20",9,29,46,52,53,30,28,26,49,17,27,17,100,77,29,33,8,43,65,51,34,25,24,17,58,54,27,21,27,26,42,25,30,57,78,18,17,42,41,53,20,17,57,13,31,54,62,17,92,81,73,33,10,32,28,35,7,"7","4",81,38,57,38,63,14,47,39,39,81,14,28,44,18,39,61,81,74,7,34,38,46,33,59,69,32,17,42,41,52,70,96,43,"5",35,98,84,32,5,43,"5","10",22,10,47,"10",44,54,19,59,89,17,34,24,71,"8","10",14,33,20,13,"20",22
"2011-02-01",61,78,5,59,26,53,26,22,13,17,23,73,10,75,42,7,22,21,21,14,61,70,35,"4",23,29,30,14,16,44,79,78,90,58,68,24,56,36,44,70,72,40,9,45,49,0,68,50,41,32,60,32,49,40,36,16,65,49,44,33,63,49,98,21,24,47,71,77,40,30,68,10,57,70,20,21,"40",58,34,48,26,58,35,62,26,5,35,59,26,45,43,34,68,40,10,4,"3","2","3",9,17,17,"4","3",3,"4",27,9,58,"3",22,49,47,22,51,52,63,64,37,34,11,16,"16",25,25,48,55,50,40,39,32,54,14,41,18,82,76,27,36,9,46,68,57,60,17,24,11,59,57,18,20,26,32,43,26,39,69,64,25,10,40,44,47,14,15,59,11,35,66,60,40,71,72,83,43,9,33,31,45,15,"4","3",72,47,56,39,61,16,55,44,37,82,22,29,43,20,43,61,64,61,7,80,39,47,38,40,67,40,21,69,27,62,65,77,42,"2",41,96,65,48,4,55,"4","12",25,11,52,"6",49,69,45,30,89,21,43,21,73,"6","5",38,62,22,14,"20",25
"2011-03-01",55,73,7,68,24,58,32,25,26,4,34,71,9,56,30,6,23,20,21,16,58,64,37,"3",17,27,25,13,19,41,81,70,89,40,73,37,58,25,44,67,67,44,8,46,66,13,64,49,46,44,57,43,55,38,31,11,68,45,41,37,64,51,86,22,17,62,66,86,23,21,54,54,55,58,19,23,"40",59,32,57,33,64,36,69,34,5,13,55,23,45,40,32,58,39,4,3,"2","1","2",12,14,17,"3","3",2,"2",25,6,58,"2",14,36,46,51,51,52,63,69,43,40,10,17,"16",26,18,45,52,50,38,33,12,57,14,34,24,79,75,45,39,6,46,71,53,64,31,25,15,70,57,19,18,25,24,45,39,29,71,66,16,18,46,30,46,13,16,56,10,38,60,59,53,71,72,81,37,12,28,32,45,10,"3","2",71,42,43,43,61,15,60,50,37,85,24,30,44,28,42,62,64,54,6,44,30,49,31,54,65,40,13,58,26,70,70,86,40,"2",46,98,62,42,8,30,"2","6",21,8,50,"3",50,64,59,47,88,11,40,23,77,"4","6",21,35,19,24,"22",19
"2011-04-01",56,66,9,59,22,63,29,25,54,16,27,68,0,60,38,6,15,20,11,17,58,65,35,"2",27,25,41,7,17,35,77,61,82,50,65,23,56,37,51,64,70,43,7,50,66,0,61,45,53,49,59,41,46,41,28,14,67,47,35,40,69,43,90,20,23,53,69,87,9,25,66,65,60,63,13,15,"41",57,49,65,38,70,44,76,43,6,5,62,24,40,39,28,53,51,4,3,"1","1","2",7,18,17,"3","1",1,"2",25,7,61,"2",24,37,44,34,47,59,59,70,42,40,22,20,"26",22,19,24,55,73,40,35,34,60,12,27,23,84,88,43,29,6,50,64,53,48,24,32,18,63,57,23,13,32,39,46,28,48,68,67,17,17,40,50,55,15,19,51,10,42,64,60,33,74,75,92,41,28,35,31,43,14,"3","1",67,43,35,44,45,14,61,50,35,72,24,30,44,20,44,65,56,48,20,40,21,52,27,68,54,45,23,52,35,90,78,83,41,"1",45,91,61,44,7,46,"4","10",24,9,52,"4",62,83,37,44,81,17,54,15,81,"5","7",32,23,16,23,"24",29
"2011-05-01",47,54,6,59,34,41,16,20,33,13,34,62,14,74,30,10,29,17,16,14,55,53,30,"2",17,26,35,7,17,48,83,63,86,40,85,29,60,27,38,60,61,51,5,38,61,0,52,46,44,43,50,43,45,37,32,16,69,44,48,38,50,37,86,23,24,70,60,88,18,20,43,0,60,55,13,19,"43",55,36,67,43,73,45,70,38,5,5,61,19,38,35,33,59,42,4,2,"1","<1","1",7,13,17,"2","<1",0,"2",23,6,50,"1",17,27,43,51,52,54,62,75,39,40,11,24,"21",27,24,26,51,33,33,29,33,45,11,36,19,87,81,33,26,4,47,65,53,48,22,15,14,64,55,18,14,35,39,45,47,55,62,70,19,33,40,39,40,15,25,56,7,30,57,52,25,88,69,72,34,22,23,30,44,21,"2","<1",67,35,23,40,35,16,51,44,35,77,19,28,46,18,44,70,58,62,6,26,38,54,29,67,64,39,13,66,39,84,68,91,40,"1",42,94,69,31,10,40,"2","5",18,7,43,"2",44,56,27,37,92,8,65,21,96,"3","5",21,31,24,28,"25",46
"2011-06-01",49,58,4,45,29,45,31,20,37,14,42,65,10,76,36,6,32,19,20,19,54,46,36,"2",10,25,20,11,14,43,100,66,90,51,78,31,49,26,34,62,60,48,4,30,55,4,46,36,40,35,52,35,41,26,21,13,78,33,43,38,54,33,97,20,19,61,56,90,57,14,24,0,57,49,7,10,"45",66,46,70,38,71,44,72,28,5,9,39,10,39,37,34,59,30,2,2,"1","1","1",9,8,16,"2","1",1,"1",23,5,53,"1",13,23,38,32,52,46,66,88,38,38,17,21,"17",10,25,34,43,53,27,25,26,38,11,40,17,94,98,40,42,9,30,55,51,71,19,16,9,59,57,27,17,27,27,50,41,43,66,71,15,35,23,35,46,13,23,54,8,32,59,48,19,91,85,99,34,23,27,35,50,7,"2","1",64,34,34,40,29,20,41,33,34,86,22,29,49,17,57,73,88,71,13,23,38,54,42,65,73,31,19,56,45,77,62,99,43,"1",48,94,87,28,5,22,"1","9",19,8,46,"4",35,50,21,46,87,11,64,10,89,"3","3",22,21,18,31,"26",26
"2011-07-01",42,59,0,39,23,35,20,14,12,11,27,60,0,100,28,7,35,27,17,19,52,41,36,"2",12,23,22,7,15,50,97,67,88,62,83,26,48,28,40,58,57,41,7,33,62,0,42,42,45,41,48,64,39,19,17,9,78,32,50,35,61,31,97,19,27,66,52,90,18,16,24,0,50,37,7,10,"46",69,42,70,37,76,47,77,23,6,5,37,9,40,41,36,68,34,4,2,"1","1","1",6,7,13,"1","<1",3,"1",22,5,47,"1",12,23,35,28,57,57,68,91,30,34,21,23,"9",11,25,29,42,41,25,26,8,35,9,60,26,87,82,28,35,8,25,53,53,42,36,14,9,58,49,11,16,26,22,52,36,38,69,68,21,34,19,43,44,11,21,44,6,60,50,45,13,98,77,92,24,29,30,38,60,7,"1","<1",64,30,48,38,38,21,38,34,36,88,19,23,50,20,57,77,84,71,7,16,43,57,37,78,66,25,22,60,57,82,58,97,41,"2",49,88,77,32,3,31,"2","4",17,6,41,"2",41,48,12,52,78,6,58,15,89,"3","4",25,19,15,29,"30",35
"2011-08-01",43,61,0,40,23,40,9,12,29,10,34,61,17,82,28,14,25,17,15,16,53,41,32,"2",15,24,30,3,16,50,85,75,84,66,83,33,64,30,33,60,59,51,4,28,89,0,42,41,47,34,50,48,39,28,22,16,65,35,50,36,63,33,98,19,20,59,53,97,26,16,33,9,52,41,9,18,"45",54,36,60,34,69,42,67,25,6,4,37,9,40,40,29,74,28,5,2,"1","1","1",5,8,15,"1","1",1,"3",22,5,48,"1",9,13,41,41,52,64,65,78,34,34,14,25,"11",6,24,28,41,37,23,29,15,32,10,44,17,84,82,31,36,8,26,53,53,81,29,15,7,69,51,23,11,25,20,50,39,33,63,84,23,27,25,42,43,15,28,50,8,40,52,52,15,100,80,64,27,33,30,33,60,0,"1","1",60,32,35,41,34,19,29,30,35,96,20,24,48,18,45,67,60,57,6,13,33,53,40,66,66,28,22,87,41,82,62,100,44,"1",43,91,89,27,3,21,"2","5",17,4,41,"3",38,54,14,64,86,4,69,9,92,"3","2",13,17,24,24,"28",25
"2011-09-01",49,53,2,49,23,49,22,23,34,12,35,64,9,49,35,6,22,20,16,17,57,64,29,"2",14,24,23,5,16,44,75,64,81,58,85,35,45,33,44,65,63,42,6,36,63,4,64,41,44,35,55,49,43,44,28,13,56,44,44,35,63,53,96,17,26,49,66,97,13,15,26,9,57,41,8,18,"40",53,45,58,31,74,40,71,24,3,0,50,22,45,34,30,83,36,5,2,"1","1","1",13,9,16,"2","2",3,"1",24,6,56,"1",11,23,45,46,44,45,70,53,33,25,21,20,"10",16,23,26,52,47,49,36,15,43,9,40,17,84,71,31,30,8,40,61,53,71,22,13,8,70,55,16,17,27,35,46,40,34,69,70,20,19,42,29,33,11,25,78,8,42,53,66,18,86,81,55,38,22,28,30,34,7,"2","1",63,35,32,35,28,22,53,37,28,80,22,34,43,19,38,60,46,47,6,12,30,50,38,53,60,38,38,73,43,79,64,88,44,"1",43,85,72,42,4,21,"2","7",20,9,49,"3",43,53,15,30,80,9,45,9,73,"4","6",20,19,16,25,"27",49
"2011-10-01",60,54,5,40,29,53,28,25,27,5,47,64,16,44,32,3,21,18,21,17,55,63,28,"2",15,23,33,0,15,42,64,56,78,53,78,25,40,37,55,61,66,41,6,38,62,4,66,36,35,37,53,42,45,36,30,22,49,45,42,33,73,47,91,17,35,48,63,91,24,20,29,16,52,47,12,29,"38",53,44,56,27,65,40,67,21,4,4,56,21,37,28,25,55,46,3,2,"1","1","1",11,13,18,"2","2",3,"3",24,6,56,"1",14,4,42,29,40,41,54,46,34,30,11,14,"11",19,40,57,50,58,45,50,18,54,11,30,23,81,64,30,40,8,45,59,49,75,26,11,7,60,54,15,15,26,33,43,41,38,66,64,21,21,40,29,42,20,20,57,10,45,64,55,20,72,64,52,33,20,22,32,39,12,"2","2",47,40,27,33,27,20,58,45,26,76,13,25,41,18,36,53,48,37,29,24,29,46,37,54,53,39,33,43,43,55,67,80,45,"<1",50,81,60,40,5,31,"3","8",21,8,46,"4",54,57,16,41,73,5,55,9,57,"5","7",12,20,10,16,"27",30
"2011-11-01",58,48,2,49,22,48,33,22,32,20,29,64,16,42,36,0,26,19,19,15,53,55,28,"2",14,24,23,3,14,41,61,55,76,56,61,22,45,24,50,62,61,36,9,37,53,0,60,37,32,35,51,36,39,41,30,12,46,45,41,32,64,47,94,13,22,42,63,87,8,23,35,0,58,49,9,17,"33",44,40,55,33,64,36,62,20,7,8,45,13,37,24,33,62,44,4,2,"1","1","1",15,12,19,"2","1",6,"2",24,5,55,"1",16,16,40,39,37,50,56,43,33,25,21,18,"10",21,25,45,53,60,43,40,30,52,11,33,29,68,72,35,35,8,47,56,44,63,24,15,9,53,50,8,11,22,26,40,52,24,70,66,24,31,43,27,32,12,6,50,8,60,56,54,20,60,70,65,30,25,22,27,39,12,"2","1",31,33,41,38,30,26,62,41,30,73,14,23,36,18,32,50,42,31,12,18,29,43,30,50,55,36,34,44,32,49,77,74,37,"1",40,78,52,45,4,36,"1","10",23,8,49,"3",48,60,22,52,66,7,40,12,53,"5","6",28,12,18,26,"26",29
"2011-12-01",46,47,0,42,23,33,19,20,28,13,43,53,8,45,29,3,24,23,19,16,45,45,26,"1",11,19,28,6,11,29,64,56,77,40,85,34,41,11,41,49,53,39,4,32,40,0,47,46,36,30,46,41,34,33,23,5,42,32,29,30,57,40,95,18,35,49,45,84,31,18,21,0,55,35,9,16,"32",55,43,63,40,64,34,62,21,7,8,36,8,36,22,30,60,30,2,1,"0","<1","1",7,9,13,"2","1",2,"2",20,4,43,"1",12,13,30,37,45,41,45,46,28,26,20,16,"7",20,30,56,44,32,35,33,11,40,9,30,19,72,53,21,35,5,35,47,45,59,25,12,9,44,44,27,11,22,26,38,43,27,64,63,14,20,28,23,36,10,15,39,6,45,44,39,20,60,65,56,28,15,22,28,33,12,"2","1",35,30,56,32,19,21,42,33,25,79,27,19,34,13,30,48,36,37,5,4,39,41,29,73,44,27,19,34,29,43,61,66,35,"<1",41,71,45,32,4,12,"1","3",17,5,40,"2",37,48,24,36,59,10,44,10,44,"4","3",18,11,8,23,"26",31
"2012-01-01",49,64,3,54,17,51,18,17,44,14,31,62,11,50,25,6,31,21,25,19,56,48,32,"2",13,22,37,3,15,32,71,70,82,55,76,32,46,11,40,59,61,40,9,40,59,10,50,41,40,33,55,38,43,38,22,14,66,39,32,37,73,39,94,21,29,55,54,91,15,12,24,29,49,39,9,19,"48",48,42,56,29,67,32,69,22,4,4,48,0,39,33,35,65,32,2,2,"1","<1","1",8,8,14,"2","1",3,"0",23,6,53,"1",17,16,41,18,45,48,65,48,35,33,21,22,"10",14,24,37,48,51,34,38,10,41,9,24,18,81,77,29,45,7,42,57,47,78,36,16,6,55,52,12,12,25,30,45,40,32,76,74,15,13,37,25,32,13,24,56,7,45,53,56,32,74,70,61,30,20,22,30,42,6,"2","1",55,32,68,43,48,26,37,36,32,84,27,26,51,18,39,60,65,49,0,11,23,53,26,59,65,30,19,45,15,63,70,88,41,"<1",41,93,62,31,5,23,"1","5",17,5,44,"3",40,48,32,45,82,8,49,11,78,"3","5",8,14,16,36,"32",37
"2012-02-01",58,69,6,52,14,48,28,22,21,7,24,67,19,39,40,4,26,27,20,18,54,62,31,"2",22,24,29,3,16,33,73,68,83,51,71,34,51,9,53,60,67,47,6,41,56,7,65,49,42,42,53,35,44,40,29,11,60,41,33,42,71,53,94,19,18,57,66,87,15,21,31,15,57,39,8,27,"47",35,37,52,30,64,40,71,30,5,4,51,27,39,34,40,57,40,5,2,"1","1","1",13,10,14,"1","<1",2,"1",22,5,57,"1",17,18,41,34,47,48,58,50,43,33,23,25,"16",13,19,28,51,52,52,34,13,55,9,37,29,77,68,25,39,7,45,56,47,49,31,18,10,63,53,20,13,30,23,45,37,34,71,64,19,33,40,28,27,12,12,65,9,33,54,53,30,70,72,74,36,16,27,32,49,6,"1","<1",48,36,86,53,33,26,60,42,30,74,22,28,49,23,39,60,69,52,11,11,21,57,35,51,50,43,20,49,27,88,64,74,43,"2",35,89,57,37,3,25,"2","6",22,9,48,"1",55,59,47,47,68,8,46,11,74,"4","5",11,19,15,32,"31",13
"2012-03-01",53,56,10,55,17,48,27,23,26,6,20,65,7,39,34,2,27,30,14,22,52,56,29,"3",20,31,34,3,13,28,76,63,82,50,77,48,52,15,44,60,59,50,7,42,55,3,61,49,35,41,55,44,46,40,22,13,64,42,28,44,63,40,89,20,19,53,60,91,11,18,24,14,56,44,9,11,"47",37,47,60,37,77,42,77,37,2,4,47,29,37,28,34,60,39,2,3,"3","2","2",14,15,17,"5","2",3,"4",25,6,59,"2",19,17,39,24,37,52,53,61,36,32,26,29,"16",18,18,28,48,47,41,30,13,51,10,26,22,78,68,28,35,8,43,60,50,72,32,18,13,61,50,19,12,27,23,45,29,31,69,62,28,13,45,31,32,15,9,55,14,35,55,53,37,64,76,75,35,25,22,36,39,8,"5","2",30,33,57,47,41,23,56,43,30,74,28,26,49,32,38,61,60,45,5,11,20,62,26,51,58,37,18,39,25,93,67,77,39,"1",37,92,58,31,11,20,"2","6",24,8,49,"4",42,54,49,28,73,19,45,14,79,"7","6",14,20,18,33,"34",15
"2012-04-01",54,55,6,52,18,61,23,23,10,11,39,62,30,58,30,2,27,27,19,19,53,58,31,"2",17,25,28,0,12,27,73,62,77,61,63,36,46,17,53,58,56,51,4,36,54,3,62,53,44,39,51,43,46,43,24,10,62,40,27,46,66,50,89,19,12,64,61,87,15,20,29,7,56,43,8,8,"50",21,45,57,34,69,44,69,34,4,4,53,8,33,33,34,67,44,4,2,"2","1","2",12,11,15,"3","2",9,"2",23,6,58,"2",19,13,43,37,44,49,53,50,34,32,22,24,"19",22,24,29,52,50,50,36,20,57,8,37,22,77,72,26,35,7,44,56,49,46,31,18,8,54,50,21,10,27,27,48,32,31,66,68,17,14,42,22,37,14,14,47,9,32,52,55,20,79,70,59,40,12,23,33,39,11,"3","1",27,30,42,39,30,27,65,49,33,75,37,24,52,30,41,63,64,38,21,9,35,62,16,55,55,40,11,40,16,85,86,80,39,"1",33,89,56,35,8,35,"4","9",24,10,49,"3",46,57,22,39,73,9,42,15,82,"5","6",20,30,13,36,"32",12
"2012-05-01",49,39,3,64,13,42,21,13,13,11,37,60,7,53,29,2,36,24,20,22,50,50,32,"2",13,20,32,0,13,26,82,65,80,59,75,38,49,9,59,56,56,47,4,34,58,13,51,39,33,31,49,45,40,34,23,12,63,35,26,47,59,40,91,18,13,61,56,84,18,15,24,7,58,47,6,15,"53",33,36,60,33,69,47,71,29,7,0,66,29,38,26,32,72,39,5,2,"1","1","1",13,8,13,"2","<1",1,"1",21,5,47,"1",14,18,41,22,48,44,58,54,33,33,38,24,"8",17,21,32,48,40,40,35,13,41,8,30,19,86,82,26,40,4,50,55,45,69,32,13,7,53,52,28,9,24,28,51,37,32,65,65,14,14,38,29,27,13,24,55,7,35,50,50,20,80,62,70,28,16,28,38,36,19,"2","1",34,27,40,32,19,27,51,35,29,73,35,29,56,27,46,64,60,48,5,6,31,59,24,55,56,33,13,52,10,76,67,89,45,"0",40,88,70,34,4,24,"1","3",19,5,43,"4",44,50,15,35,83,12,38,11,97,"4","3",11,24,18,36,"33",18
"2012-06-01",47,43,6,42,22,38,21,20,20,7,30,57,8,54,28,2,38,31,26,25,48,42,27,"5",16,47,30,3,10,27,92,65,86,60,74,42,49,10,45,56,54,60,7,33,44,0,43,37,44,40,48,40,35,20,17,9,63,29,27,49,69,35,96,15,17,60,50,79,15,10,13,0,51,45,5,12,"55",25,46,59,34,72,42,68,22,7,0,39,19,37,26,35,67,26,2,5,"3","1","4",20,13,20,"7","6",4,"5",33,9,49,"4",15,12,35,28,44,43,60,63,34,30,32,32,"4",18,20,39,38,31,30,30,14,39,15,29,23,89,71,26,24,3,29,51,48,59,41,10,5,49,49,27,11,26,22,57,32,33,68,64,19,19,23,32,37,18,15,46,29,37,49,46,10,80,73,72,23,23,23,40,42,6,"7","5",45,26,39,35,27,30,41,31,32,83,29,25,59,33,52,71,87,53,11,5,47,60,17,55,61,26,11,49,17,71,46,89,43,"2",56,89,68,25,9,29,"3","16",29,10,48,"4",39,44,13,34,74,17,41,7,98,"9","8",17,19,14,37,"34",22
"2012-07-01",41,35,5,43,15,39,16,15,13,8,34,55,0,63,29,8,31,35,23,26,50,40,29,"4",15,28,31,0,8,28,94,69,87,59,74,41,49,10,39,53,52,43,6,30,46,0,39,42,33,32,44,40,31,20,16,10,68,28,28,45,57,37,89,18,15,58,47,76,14,12,18,14,56,46,6,19,"61",25,38,61,31,69,41,70,20,9,7,38,29,38,31,39,65,26,6,4,"6","2","3",11,6,20,"5","3",7,"3",25,7,46,"2",15,8,34,24,43,52,61,68,31,27,37,43,"5",11,22,33,39,34,27,25,10,33,13,37,20,86,76,31,49,8,23,51,48,68,41,6,6,47,46,17,9,25,21,61,39,33,64,69,19,29,18,34,37,19,8,45,11,32,48,46,11,75,72,80,22,28,23,42,47,5,"5","3",33,23,43,37,18,29,31,33,30,84,24,28,64,21,54,76,79,56,0,21,37,62,30,59,54,25,25,46,12,63,58,91,44,"2",51,91,72,20,5,32,"3","6",21,6,43,"6",33,41,11,42,81,14,46,6,94,"4","5",16,18,14,44,"35",29
"2012-08-01",44,42,3,45,13,33,15,21,15,3,36,56,7,70,25,5,34,38,21,23,50,39,28,"2",11,24,31,0,8,26,85,72,83,44,80,41,54,18,34,54,54,54,5,28,59,0,38,40,35,41,47,41,32,30,20,14,56,33,26,50,61,40,85,17,20,50,48,66,10,11,17,14,54,46,6,11,"55",22,48,64,29,70,39,67,21,5,0,39,7,41,32,38,57,24,3,2,"3","1","1",4,9,17,"1","1",2,"1",22,5,52,"1",13,15,42,18,41,53,61,54,28,24,35,40,"6",8,19,32,35,38,30,24,16,33,8,36,20,90,63,28,36,7,24,54,48,70,41,6,6,52,48,28,11,30,17,60,28,27,59,81,13,29,27,24,37,14,8,48,9,31,47,46,16,81,77,58,19,12,21,44,45,5,"1","1",26,23,33,42,21,32,31,29,28,92,27,21,58,31,44,65,56,47,0,10,31,58,29,61,70,23,14,39,19,63,52,87,50,"2",50,89,67,25,2,23,"1","5",17,5,41,"4",36,42,17,28,85,8,49,8,88,"4","4",13,20,14,43,"34",16
"2012-09-01",50,38,3,53,18,52,34,21,20,10,39,60,0,26,39,6,38,28,22,20,53,61,27,"2",18,23,26,0,9,23,70,65,79,46,95,34,39,22,54,57,59,45,5,41,57,3,65,41,40,34,52,40,37,39,23,14,45,43,23,45,75,48,78,14,16,49,61,62,18,19,25,14,60,45,9,0,"50",21,36,63,34,74,42,68,23,4,18,55,15,34,30,33,62,45,2,2,"5","1","1",8,11,17,"3","3",5,"3",23,5,59,"1",19,19,40,20,35,44,58,44,33,28,30,39,"10",11,22,36,46,58,47,38,29,52,8,37,15,89,62,27,27,7,38,56,45,70,39,13,7,53,56,13,14,31,23,53,34,30,63,69,11,14,41,30,36,11,18,64,8,22,58,59,24,66,66,47,33,22,23,36,37,5,"3","2",29,33,21,39,21,27,55,38,26,80,37,28,52,33,35,56,37,35,15,15,23,56,22,46,62,35,21,46,15,69,81,78,43,"2",47,86,59,44,2,29,"1","7",25,8,50,"4",50,59,21,48,75,9,38,11,76,"5","4",24,19,9,36,"33",22
"2012-10-01",55,32,3,53,11,57,31,28,30,5,44,61,0,24,34,5,36,23,17,16,55,62,25,"2",17,25,32,4,7,17,64,54,74,39,63,44,39,12,48,56,61,39,7,37,54,0,68,35,31,30,51,44,39,41,20,8,37,40,17,40,73,50,82,15,12,44,59,68,22,18,24,19,59,45,9,26,"47",14,36,60,31,74,39,69,30,1,6,49,16,40,24,34,53,50,2,2,"4","2","1",10,8,20,"2","5",2,"1",24,5,60,"1",13,27,39,32,30,37,52,35,31,24,34,29,"8",23,22,57,46,55,43,37,14,58,8,30,21,77,61,19,27,7,43,52,45,65,40,12,8,52,74,21,10,23,26,46,49,25,63,67,13,13,42,29,30,14,9,47,9,20,56,54,23,60,68,46,30,20,22,33,39,0,"2","4",43,33,28,34,25,28,76,45,24,72,30,23,50,27,29,45,30,26,18,13,38,48,24,48,57,34,20,47,12,58,67,75,44,"2",34,78,56,47,2,33,"1","6",23,5,49,"2",58,62,25,37,69,13,36,6,56,"4","5",22,17,8,36,"31",9
"2012-11-01",51,36,5,49,11,54,16,17,24,8,34,53,0,20,30,4,24,18,21,20,53,54,23,"2",16,27,29,0,7,24,57,52,74,31,72,36,36,20,57,49,53,47,4,38,57,0,57,35,25,32,47,38,34,38,19,11,33,37,24,35,76,45,85,12,15,46,56,68,13,21,25,7,59,47,10,14,"44",19,31,63,34,71,41,67,22,2,0,48,20,32,22,36,51,44,3,2,"2","1","1",16,12,19,"2","2",2,"2",23,6,55,"1",18,14,38,24,39,37,48,33,28,24,32,32,"12",23,21,47,46,57,41,33,30,45,13,23,19,67,51,15,17,3,41,48,41,74,37,15,7,54,67,20,8,20,21,46,36,29,62,54,7,21,37,17,29,13,7,44,11,28,54,46,18,49,63,36,29,14,23,32,40,5,"2","2",37,28,16,31,15,27,58,41,24,72,28,21,47,14,32,44,29,30,5,8,22,45,26,91,48,33,20,48,16,58,70,67,41,"1",45,73,46,39,6,13,"2","7",24,5,49,"4",49,57,23,35,62,8,32,15,38,"5","6",20,15,11,21,"28",19
"2012-12-01",43,31,2,49,21,39,20,16,15,12,31,47,13,31,27,4,25,24,18,20,41,44,21,"1",10,21,29,0,9,24,57,51,73,36,57,32,31,23,46,45,60,38,1,27,45,3,48,40,28,28,41,40,29,30,16,2,34,29,24,39,59,38,85,10,14,39,47,73,13,13,15,13,55,35,6,17,"44",15,44,64,38,63,30,58,18,5,0,37,17,33,20,27,59,31,1,1,"1","<1","1",7,5,11,"<1","<1",2,"1",17,4,44,"<1",12,13,28,20,33,31,41,32,29,23,25,28,"9",14,29,56,42,54,37,35,17,41,7,27,16,64,43,15,18,3,35,45,38,63,41,8,7,41,43,21,11,21,21,44,35,23,54,56,7,19,28,27,34,11,9,55,6,28,41,36,13,45,60,52,26,21,25,34,31,5,"<1","<1",24,28,18,29,17,27,47,32,24,66,25,22,47,23,31,46,32,30,0,7,25,44,24,75,40,24,23,51,19,50,58,58,39,"0",25,66,40,28,8,17,"1","5",17,4,36,"0",44,49,12,33,58,4,46,7,37,"2","3",20,9,10,23,"28",20
"2013-01-01",50,42,2,54,7,47,23,21,31,10,25,58,0,30,30,2,35,24,18,22,51,50,27,"2",11,25,34,5,9,24,67,55,76,48,53,37,46,14,51,56,62,48,4,35,64,3,50,41,27,32,50,45,39,33,20,13,53,40,24,53,73,39,82,13,7,46,55,80,9,12,20,30,52,40,6,6,"65",19,40,57,28,65,30,65,19,4,0,48,15,38,34,50,58,32,3,2,"2","<1","1",5,7,13,"<1","<1",4,"1",21,5,53,"<1",10,10,35,17,30,45,58,38,36,28,30,29,"7",20,24,50,45,49,35,31,19,41,8,15,25,87,71,21,24,5,38,58,42,68,37,8,5,49,53,14,10,24,24,48,25,30,64,72,14,14,36,20,26,11,8,47,8,24,53,49,14,65,74,56,32,13,23,32,33,4,"<1","<1",24,29,43,39,31,27,46,30,31,73,40,24,68,28,36,58,63,42,0,11,29,55,18,48,60,29,21,52,20,55,54,85,38,"<1",34,89,60,29,5,16,"1","4",16,3,43,"3",51,52,10,51,77,3,46,6,56,"4","2",16,21,10,41,"35",16
"2013-02-01",56,48,4,43,14,62,34,30,20,6,39,63,7,23,35,3,38,27,17,23,51,62,27,"2",18,25,39,3,10,20,69,66,78,42,57,43,40,16,64,58,69,44,8,38,50,0,65,38,35,35,51,37,46,37,21,11,49,42,20,51,68,45,85,16,7,42,66,79,16,12,20,6,59,43,6,27,"68",20,55,54,26,64,33,66,21,3,10,46,13,38,30,45,62,45,1,1,"1","1","1",6,9,13,"<1","1",2,"1",21,5,55,"<1",14,10,40,26,29,39,52,42,37,31,35,30,"5",15,21,39,48,54,50,38,38,56,9,30,28,77,60,15,25,10,44,57,45,83,41,11,6,46,54,15,9,25,30,50,38,29,64,60,14,7,42,29,27,10,6,62,9,27,51,49,14,56,67,54,38,15,26,36,38,0,"<1","<1",41,32,29,41,25,30,69,42,29,68,43,20,71,32,35,53,48,37,9,13,25,59,17,49,47,32,17,45,14,54,67,77,38,"<1",37,86,57,39,4,20,"1","7",19,5,45,"3",63,69,13,48,73,6,41,9,59,"4","3",10,23,10,35,"38",15
"2013-03-01",47,41,5,48,12,44,35,31,23,6,31,61,0,26,31,2,32,36,19,27,48,57,29,"2",11,26,41,5,10,28,74,60,79,36,61,51,45,9,62,58,66,47,5,37,57,0,60,36,37,33,51,44,39,36,20,11,52,39,28,56,78,47,85,16,9,51,59,78,12,11,19,12,60,44,7,19,"69",16,30,60,25,70,35,70,22,4,3,46,12,34,32,38,57,40,4,2,"1","<1","1",6,5,12,"1","<1",0,"1",21,4,58,"<1",14,11,36,39,25,38,48,46,32,32,51,42,"11",17,20,33,47,58,44,32,13,53,10,30,24,77,72,21,19,11,45,57,42,65,51,11,4,47,53,16,10,27,28,51,31,31,54,63,13,13,34,21,24,11,10,50,10,27,52,50,15,57,74,63,35,14,24,42,32,9,"1","<1",39,29,34,39,33,35,71,40,31,74,43,32,71,34,38,58,52,30,0,10,28,66,25,40,58,33,22,43,25,53,74,74,38,"<1",41,89,54,30,3,25,"1","6",21,4,45,"2",61,58,17,31,67,10,41,5,67,"3","2",18,22,11,43,"44",11
"2013-04-01",58,33,3,48,12,62,24,27,25,9,14,63,6,28,33,0,44,30,22,25,51,60,30,"1",12,26,38,2,9,21,71,57,74,43,61,42,42,15,63,56,83,50,3,43,54,0,62,31,27,27,49,34,39,39,20,10,49,39,21,59,72,46,82,16,9,57,67,76,18,16,24,42,57,46,7,19,"71",12,38,58,26,71,33,65,19,4,0,49,28,38,29,40,67,44,3,1,"<1","<1","1",9,9,13,"1","<1",1,"1",22,5,57,"<1",15,16,40,24,26,39,57,40,42,33,41,41,"7",25,20,32,46,50,44,32,22,56,11,21,16,73,65,24,23,7,43,58,44,61,46,9,7,47,54,23,7,25,29,53,33,32,57,62,10,10,41,22,26,12,10,46,9,32,56,51,13,59,64,59,36,16,22,38,32,0,"1","1",24,32,28,36,22,36,71,49,34,67,41,29,73,31,38,57,47,39,4,5,30,68,22,40,55,40,18,55,22,50,64,83,41,"<1",33,83,58,37,0,20,"1","5",19,4,48,"3",71,73,15,33,75,13,36,11,67,"4","3",16,19,11,49,"46",10
"2013-05-01",49,26,2,48,11,43,19,24,16,6,16,59,6,25,25,4,41,41,26,26,47,49,27,"1",12,23,40,5,11,22,76,57,77,34,60,41,41,9,58,58,57,55,7,39,51,3,50,35,27,29,47,39,32,39,21,14,51,33,22,53,57,39,81,16,9,54,56,73,6,13,20,12,61,50,6,19,"73",16,37,56,29,75,34,70,20,4,3,49,9,30,28,41,59,33,3,1,"1","<1","<1",6,7,11,"1","<1",2,"1",20,5,49,"<1",13,15,41,14,25,45,61,45,36,30,52,49,"7",20,30,44,47,44,38,27,8,44,9,26,20,82,71,29,19,6,38,49,44,67,52,10,6,54,53,16,9,26,23,56,30,33,69,65,14,12,36,17,29,10,2,45,7,21,46,48,13,66,65,60,43,17,21,41,31,9,"1","<1",21,27,19,30,17,35,56,31,31,67,44,30,78,29,45,61,52,39,4,5,33,66,24,43,52,35,16,40,26,48,62,86,48,"<1",37,82,62,32,2,19,"1","4",15,5,42,"1",50,56,10,31,76,12,45,5,70,"4","2",18,17,10,58,"49",14
"2013-06-01",43,26,1,41,12,38,22,21,18,6,24,55,10,37,22,3,41,47,20,27,43,39,27,"1",12,20,52,0,9,22,87,61,82,33,68,49,41,13,39,54,56,56,3,28,48,0,37,37,35,31,44,49,30,21,12,12,51,28,22,58,54,32,84,14,10,50,48,73,13,6,12,13,55,43,3,26,"76",13,36,62,30,73,35,67,19,2,6,38,10,40,24,45,62,28,3,1,"<1","<1","<1",3,5,12,"1","<1",2,"1",19,4,47,"<1",13,13,34,7,16,44,56,59,34,28,59,52,"5",6,21,34,36,32,28,21,6,35,9,35,11,87,68,27,22,5,26,41,44,75,51,8,4,46,46,12,13,27,18,63,27,28,61,61,12,14,24,24,32,11,3,32,6,28,47,45,12,58,69,72,27,23,19,46,38,5,"1","<1",31,23,17,31,15,37,40,26,31,70,46,25,79,39,50,64,72,48,0,4,30,68,21,52,56,26,20,41,26,54,62,87,44,"<1",34,82,62,18,2,16,"1","4",14,4,39,"1",40,47,9,54,75,12,33,8,76,"3","2",17,19,11,56,"53",23
"2013-07-01",44,30,1,43,11,47,24,19,16,6,23,53,6,52,22,0,37,41,18,30,44,37,32,"1",10,25,49,4,6,18,88,59,84,23,59,53,42,15,49,53,53,53,5,28,40,9,38,37,37,33,45,47,27,19,11,8,52,28,18,59,64,32,85,13,7,51,47,74,6,10,16,18,55,44,3,6,"80",14,37,64,34,81,42,73,20,2,3,39,12,34,28,46,63,21,3,1,"1","<1","<1",5,5,13,"1","<1",3,"1",20,4,47,"<1",15,8,30,14,21,44,58,61,33,27,60,57,"3",9,16,36,39,27,28,21,6,32,9,31,22,87,68,25,12,10,23,47,45,80,61,8,2,44,44,17,12,29,17,67,25,23,61,62,13,14,18,24,31,12,2,34,9,23,42,43,10,59,68,80,23,15,22,50,33,0,"1","<1",29,23,24,36,11,37,36,28,35,83,43,19,83,35,47,64,75,50,0,5,26,70,23,55,55,24,18,47,19,66,50,89,48,"<1",44,83,61,16,0,12,"1","2",13,3,37,"2",43,43,12,40,79,8,44,7,68,"3","2",12,14,12,54,"55",19
"2013-08-01",38,28,2,47,9,33,13,14,9,7,27,53,18,49,26,2,53,31,18,27,43,37,27,"1",12,25,51,5,7,21,78,63,80,34,52,42,46,12,26,54,50,51,2,27,53,6,38,38,34,30,45,38,31,24,14,9,47,31,21,57,60,32,85,14,7,52,46,71,6,7,14,6,51,42,3,0,"74",15,38,65,30,77,44,71,19,2,3,38,9,28,28,48,67,22,6,1,"<1","<1","<1",13,6,13,"1","0",2,"0",20,4,47,"<1",12,6,38,24,18,42,58,54,32,24,58,48,"4",7,22,36,39,33,24,19,0,28,10,32,17,84,67,25,19,4,23,44,44,64,69,8,5,50,44,24,12,32,18,64,21,25,58,71,10,11,25,27,30,13,9,45,7,22,45,46,12,62,71,55,22,18,25,45,32,0,"1","<1",26,22,42,38,16,36,29,24,31,81,49,27,77,38,45,59,54,33,0,4,32,68,23,53,50,24,21,46,24,55,67,85,47,"<1",28,83,64,17,2,16,"<1","3",15,4,37,"0",37,42,11,42,77,4,46,6,62,"3","2",9,13,7,50,"54",23
"2013-09-01",48,22,5,43,4,47,30,26,14,4,22,60,0,27,31,2,37,34,16,27,52,60,25,"2",13,37,49,2,8,22,69,56,74,38,58,36,42,12,46,57,59,50,5,36,57,6,65,36,34,36,49,39,33,37,18,15,39,42,22,51,61,41,78,12,10,47,64,66,0,12,17,30,54,39,6,12,"67",12,40,57,28,71,40,66,20,4,6,48,6,29,24,38,60,45,5,2,"2","<1","1",10,7,20,"3","2",2,"1",26,5,57,"<1",27,11,39,22,17,40,57,38,30,25,50,49,"7",14,22,41,49,52,55,34,16,48,16,32,19,78,56,25,16,5,36,48,43,46,58,10,4,55,48,19,9,31,25,57,34,23,56,64,3,10,41,18,30,19,7,61,12,22,55,48,14,54,64,42,32,14,20,40,27,5,"3","1",22,29,35,41,11,34,62,38,28,75,40,32,68,46,33,48,46,24,0,4,30,61,18,46,49,32,19,33,19,55,68,81,41,"1",40,79,58,39,2,16,"1","7",24,6,50,"2",53,54,14,35,66,12,34,12,50,"6","3",5,6,11,47,"47",9
"2013-10-01",55,34,3,47,1,51,38,27,24,3,28,61,6,21,35,3,33,32,15,23,54,66,26,"3",17,56,48,2,10,22,62,51,71,32,52,44,29,12,53,61,67,52,11,39,50,0,72,38,30,27,55,34,40,37,20,11,34,45,22,46,78,48,77,14,15,47,65,62,12,12,17,11,58,40,8,15,"63",11,36,55,26,71,30,65,19,3,6,49,27,34,24,45,58,45,3,2,"2","1","1",11,12,30,"4","2",2,"1",35,8,66,"<1",29,12,39,28,16,31,57,37,36,22,42,44,"7",18,17,48,48,58,52,35,37,61,17,26,28,76,59,20,23,5,44,56,44,54,47,11,4,56,51,17,10,26,27,55,41,24,60,62,6,8,45,18,33,26,4,49,19,18,58,55,12,56,62,45,34,10,23,38,32,0,"4","2",30,34,23,39,11,37,77,49,31,65,50,24,64,24,30,48,35,31,4,7,34,56,21,42,37,35,11,34,17,47,70,78,41,"<1",31,81,55,46,4,22,"2","7",30,5,58,"2",64,70,13,45,66,21,33,6,50,"7","6",15,14,11,55,"44",6
"2013-11-01",52,24,5,46,7,47,33,23,23,4,30,58,0,24,34,4,38,41,17,27,51,54,22,"2",20,36,44,0,9,29,60,50,71,26,54,32,33,12,43,53,56,47,5,42,50,0,64,34,32,30,47,36,34,39,16,9,33,42,29,40,79,53,73,13,8,40,58,62,6,11,20,12,63,45,6,9,"59",11,49,58,29,67,30,66,16,4,0,49,22,30,23,40,60,38,5,1,"1","<1","1",14,6,23,"3","1",1,"1",26,7,60,"<1",20,18,33,20,21,29,60,36,28,27,61,43,"15",20,22,67,48,50,45,27,5,49,12,18,28,68,55,19,17,6,43,49,39,52,56,12,5,53,46,26,7,26,26,52,31,22,61,60,10,10,40,21,26,21,2,42,13,21,48,47,11,42,62,40,28,11,24,36,27,0,"3","1",28,27,22,44,12,31,66,45,26,61,37,26,58,30,29,45,29,22,17,6,19,54,19,44,36,34,12,35,18,46,66,65,34,"<1",39,75,46,32,1,28,"1","5",23,5,50,"1",54,55,15,49,62,18,35,9,38,"5","6",18,17,6,42,"40",20
"2013-12-01",42,24,2,49,8,42,23,17,15,10,23,50,0,29,25,2,33,37,16,25,40,44,22,"1",13,27,47,5,6,26,58,51,73,33,59,37,31,16,51,46,52,51,3,25,43,3,50,31,26,26,49,39,26,29,13,12,32,30,26,41,64,36,78,15,9,37,45,61,12,9,15,17,60,36,5,9,"53",17,51,68,41,72,29,63,15,2,6,42,9,30,19,35,48,31,3,1,"1","<1","<1",6,6,18,"1","<1",0,"0",22,5,45,"<1",15,11,27,47,26,28,49,37,29,24,32,39,"9",15,31,46,41,49,34,28,5,45,8,18,22,63,55,20,18,4,37,41,39,40,54,9,5,49,38,11,6,23,24,49,34,24,55,55,11,8,32,16,29,20,2,40,9,22,44,35,11,44,63,43,27,13,25,35,29,0,"1","1",24,30,20,47,6,28,53,30,24,66,30,19,55,27,30,41,41,29,0,5,22,48,11,58,41,24,12,37,15,49,64,60,34,"0",26,67,42,29,2,19,"1","4",18,4,41,"1",56,52,11,38,54,6,39,3,30,"2","2",18,14,8,40,"38",16
"2014-01-01",49,40,2,56,5,52,29,23,12,9,26,59,6,26,25,2,44,39,21,29,52,48,27,"1",13,29,53,4,9,20,69,56,76,26,48,47,37,15,53,55,57,55,2,32,53,0,52,34,27,30,53,41,36,33,18,11,47,36,20,58,77,39,74,17,12,46,56,63,17,9,14,11,56,39,5,17,"78",14,39,64,28,74,34,73,16,4,6,44,6,38,33,51,55,29,6,1,"0","<1","<1",9,6,17,"1","0",0,"1",23,5,53,"<1",16,9,38,23,18,33,59,44,39,29,57,47,"6",15,20,50,46,65,37,30,5,42,8,20,21,84,76,24,31,7,38,51,40,54,67,8,4,60,48,24,8,30,20,56,23,27,56,69,6,6,38,16,24,16,5,47,9,25,55,48,10,56,62,58,28,12,27,40,27,0,"1","1",22,27,43,59,16,39,46,30,29,68,51,24,79,30,36,51,56,44,4,4,28,63,17,45,55,30,12,27,30,53,64,85,38,"0",42,86,56,28,2,22,"1","2",17,2,44,"1",62,57,11,35,78,3,46,5,55,"2","2",21,15,10,52,"49",19
"2014-02-01",58,42,2,56,3,60,36,30,6,3,26,66,0,17,30,3,44,35,19,30,54,61,27,"1",13,27,53,0,12,20,69,66,79,31,41,49,34,11,55,55,64,52,1,48,54,0,70,33,31,32,52,33,38,35,19,8,44,40,20,56,79,45,78,18,9,45,64,61,15,12,24,12,62,43,7,12,"81",8,35,54,24,69,29,65,21,5,3,50,6,38,30,46,55,45,3,1,"<1","0","<1",12,8,16,"1","<1",0,"1",22,5,57,"<1",18,11,38,27,10,35,59,43,39,26,60,50,"7",11,20,36,49,60,57,36,19,58,7,22,31,74,60,18,25,8,46,54,42,59,72,9,3,59,49,10,7,34,23,57,24,17,52,66,11,2,42,17,25,15,2,48,8,22,57,48,13,50,66,65,38,8,22,43,27,5,"1","<1",19,33,28,51,16,37,70,45,30,67,51,26,83,33,37,51,41,34,13,10,28,68,13,40,42,35,13,42,16,58,73,72,41,"0",34,86,54,38,1,20,"1","2",19,4,47,"1",64,64,10,37,68,9,32,5,51,"2","2",16,21,8,54,"50",15
"2014-03-01",59,35,2,53,5,60,35,31,10,4,26,61,11,29,33,4,50,43,24,34,51,56,28,"1",13,28,65,3,10,20,75,61,79,28,60,60,38,8,65,58,59,54,4,46,50,3,65,35,36,34,51,37,37,35,19,10,47,36,20,62,74,43,72,22,9,43,60,62,5,11,28,11,60,48,7,6,"83",10,43,56,27,78,36,71,20,5,3,47,14,29,30,45,61,42,4,1,"<1","<1","<1",8,7,21,"1","<1",0,"0",25,5,58,"<1",9,20,38,22,15,43,60,50,36,29,64,56,"12",17,22,37,46,59,45,31,17,54,7,18,30,72,67,22,13,5,41,53,42,46,61,15,7,56,47,7,7,31,27,57,25,21,58,61,10,4,35,26,39,17,7,43,9,27,53,47,14,45,71,59,34,11,23,49,27,8,"1","<1",34,31,37,49,12,37,69,40,33,64,60,29,85,48,38,52,55,33,19,13,25,73,17,47,44,37,13,35,28,51,74,74,39,"<1",46,87,48,37,2,21,"<1","5",20,3,47,"1",53,63,11,30,71,7,37,8,60,"3","2",27,19,10,67,"57",22
"2014-04-01",59,31,3,49,3,60,38,28,9,4,38,65,6,31,37,0,45,41,22,29,51,60,27,"1",10,27,63,5,12,21,70,58,74,40,44,53,38,8,57,56,59,48,3,46,47,3,67,33,36,33,51,33,39,38,17,16,43,39,21,59,75,41,73,20,13,44,63,58,14,13,30,34,66,51,8,15,"81",6,39,59,29,73,39,71,17,3,3,56,15,33,29,46,57,46,3,1,"<1","0","<1",10,6,16,"1","<1",1,"0",22,5,57,"<1",16,15,39,14,13,39,54,44,42,32,51,60,"8",26,24,29,50,62,50,36,33,64,5,22,19,71,63,16,18,5,43,50,44,65,64,10,5,57,50,14,8,31,23,59,29,33,55,72,8,3,43,20,29,12,5,42,7,20,59,47,13,51,63,52,44,13,23,43,26,4,"1","<1",23,31,13,40,9,40,78,47,36,61,48,29,84,48,39,53,46,31,12,13,17,76,16,45,45,42,11,37,28,49,69,80,36,"0",30,82,53,38,2,24,"1","2",20,3,48,"<1",66,65,13,25,69,11,28,10,52,"2","2",15,23,7,64,"57",14
"2014-05-01",48,27,3,50,3,41,24,20,8,4,41,57,0,28,33,6,47,48,19,36,48,48,28,"1",14,23,63,5,10,23,76,55,75,33,52,54,37,7,72,56,56,63,4,34,47,0,55,30,26,31,49,32,30,32,19,12,42,35,23,61,61,35,74,19,11,51,54,60,6,13,22,12,65,56,7,12,"83",10,37,67,30,85,36,73,19,4,6,51,6,36,25,53,68,37,4,1,"<1","<1","<1",6,5,12,"1","0",0,"0",19,5,51,"<1",13,17,37,7,16,35,61,50,32,25,60,50,"4",16,21,31,48,44,37,27,25,49,5,23,23,71,67,25,28,7,40,48,43,49,85,6,4,56,46,19,13,31,26,62,28,25,55,66,9,3,40,20,29,10,3,41,7,18,47,44,11,45,63,54,28,12,23,47,26,0,"1","1",20,26,21,35,10,42,61,34,32,65,48,29,86,56,39,53,46,36,4,11,17,76,17,50,41,34,14,40,19,62,74,80,38,"<1",27,83,53,29,1,22,"1","1",16,3,45,"2",50,63,7,32,69,4,42,8,60,"2","2",14,20,7,67,"63",18
"2014-06-01",41,28,0,42,9,38,23,23,11,1,30,59,7,39,25,0,49,51,20,37,45,42,28,"1",10,24,62,0,7,25,82,57,79,36,56,62,36,9,53,56,54,74,2,29,38,0,42,30,30,36,46,35,30,24,15,14,46,30,25,60,62,31,74,15,19,52,49,60,14,8,23,14,54,48,4,7,"83",7,44,74,35,84,43,79,20,4,7,45,14,37,24,58,59,25,2,1,"<1","0","<1",6,7,14,"<1","0",0,"1",19,4,49,"<1",14,15,33,23,15,36,64,60,31,25,59,63,"3",8,20,42,39,30,33,21,19,36,4,17,20,75,68,22,15,5,28,41,42,61,89,8,4,54,46,10,11,36,24,69,28,26,51,62,8,3,24,25,35,13,3,39,6,17,43,46,15,52,68,70,28,16,22,55,29,5,"<1","<1",17,24,30,34,8,43,42,29,33,74,56,24,84,63,43,62,69,44,5,10,23,78,17,54,40,26,16,33,19,59,66,79,37,"<1",35,81,54,22,1,6,"<1","4",12,3,40,"1",46,48,14,29,73,5,37,5,60,"2","1",26,22,10,75,"65",14
"2014-07-01",42,21,1,51,6,43,25,21,9,5,30,59,7,47,22,9,50,56,27,39,47,39,30,"1",10,24,74,5,7,26,90,58,82,31,59,69,39,10,58,56,54,68,1,30,36,0,40,30,36,31,49,33,28,20,13,18,50,32,26,63,57,36,78,17,18,49,49,60,7,7,21,13,59,52,3,14,"85",11,55,70,33,93,46,85,18,6,0,36,14,42,23,61,73,27,2,1,"0","0","<1",2,6,14,"1","<1",0,"1",20,4,54,"<1",11,9,28,24,8,42,63,68,35,27,65,76,"6",11,21,44,41,33,33,21,6,37,5,19,21,80,60,15,22,4,22,46,46,67,87,6,2,49,45,12,9,32,21,75,36,21,51,64,13,6,18,20,27,14,4,37,7,29,51,45,8,59,74,66,26,14,26,56,33,8,"1","<1",27,24,28,40,13,41,41,28,32,78,56,31,89,37,50,66,80,43,0,6,24,78,22,58,43,25,10,46,24,56,52,80,34,"0",34,85,58,15,2,16,"<1","3",13,2,38,"1",33,45,7,38,71,3,35,5,62,"1","1",15,18,8,69,"69",24
"2014-08-01",41,23,0,39,2,30,20,18,12,4,24,54,0,45,26,6,52,54,20,37,44,37,25,"1",12,22,64,3,9,20,78,60,76,31,58,55,40,10,47,53,50,70,2,29,49,3,39,35,33,33,47,33,28,23,14,11,42,28,20,63,54,29,75,26,14,47,49,59,10,7,15,7,56,44,5,10,"81",6,46,67,32,88,45,80,17,4,0,36,10,36,22,59,62,22,5,1,"<1","0","<1",7,5,13,"1","<1",1,"1",19,4,52,"<1",10,17,35,37,12,40,58,58,34,25,59,58,"9",8,17,45,40,36,29,22,9,31,3,24,22,77,56,15,13,6,25,46,41,57,86,7,3,50,42,14,10,33,18,70,32,17,55,68,10,5,24,18,23,11,3,41,6,18,49,45,10,49,73,50,27,16,21,55,28,0,"1","<1",26,24,19,38,7,45,32,24,30,69,57,30,82,50,39,55,52,33,5,6,27,76,19,56,41,24,22,44,26,53,54,76,38,"<1",36,78,55,14,2,15,"<1","1",11,1,38,"1",33,41,7,33,70,3,34,6,54,"1","1",12,11,9,88,"67",39
"2014-09-01",52,24,2,49,0,55,26,28,12,5,31,66,6,23,43,0,47,50,15,30,52,61,27,"1",14,23,51,5,8,20,62,52,68,40,55,45,31,5,74,61,59,63,2,37,49,3,72,33,35,29,53,35,33,39,22,12,34,40,20,56,64,44,73,15,10,45,72,57,9,9,21,0,62,48,5,7,"76",9,50,66,29,83,34,73,17,3,3,48,13,33,20,51,70,39,4,1,"<1","0","<1",10,8,14,"1","<1",0,"0",21,5,60,"<1",16,12,38,12,16,31,62,36,32,22,52,50,"5",10,21,43,55,46,68,37,23,50,4,27,23,77,61,20,14,6,38,50,43,58,77,7,2,59,49,9,8,33,19,63,28,23,53,64,8,2,47,15,32,13,3,72,7,19,54,51,14,47,65,34,35,12,20,43,23,5,"1","<1",20,30,18,34,9,41,57,39,29,62,50,32,78,55,34,46,44,19,13,7,20,67,23,48,33,37,18,39,14,51,82,75,36,"<1",36,79,49,34,0,20,"<1","3",18,2,48,"4",47,51,11,42,68,7,33,6,50,"2","2",17,17,11,57,"58",24
"2014-10-01",60,23,1,52,1,52,38,29,10,3,30,67,0,14,38,2,46,47,14,29,52,64,24,"1",12,25,60,2,9,22,61,47,68,37,49,50,30,7,53,58,67,52,3,41,44,0,74,31,37,28,53,32,33,42,21,11,29,43,22,59,63,47,74,15,11,38,66,57,18,14,22,6,60,46,7,6,"71",10,51,62,27,85,33,76,22,2,3,55,44,35,20,53,67,49,3,1,"1","0","<1",8,6,16,"1","<1",1,"1",22,5,61,"<1",16,18,35,22,10,33,61,38,41,25,51,70,"8",20,22,36,57,53,54,37,30,60,5,12,21,68,52,18,16,5,46,53,40,43,67,7,4,53,48,12,9,34,25,58,25,22,46,61,10,5,46,14,25,14,2,41,8,24,53,50,11,45,60,42,33,13,19,45,30,5,"1","<1",17,37,21,34,6,42,83,52,29,52,45,28,73,39,33,47,35,19,21,5,19,67,24,47,44,39,16,45,21,48,87,66,42,"0",38,76,46,39,1,23,"<1","4",19,3,52,"0",57,56,14,32,62,8,40,5,40,"3","3",23,13,8,68,"56",13
"2014-11-01",52,18,2,51,6,62,32,24,17,4,34,57,0,12,30,2,35,42,16,31,49,52,21,"1",11,25,59,3,9,24,54,45,66,30,47,46,33,8,64,48,51,54,2,34,40,0,62,29,33,29,47,29,28,39,21,10,28,39,24,56,68,38,70,12,11,36,56,59,6,11,13,0,67,46,7,13,"67",8,49,61,30,79,33,71,18,2,10,54,16,31,19,47,59,42,2,1,"<1","0","<1",4,6,17,"1","1",0,"0",21,4,57,"<1",13,14,31,18,9,30,45,35,35,24,60,57,"3",17,18,68,51,58,53,31,11,50,6,19,17,67,50,10,13,5,42,48,41,62,56,7,6,49,43,16,6,26,20,54,25,19,52,59,6,2,38,20,32,13,9,41,8,24,53,46,12,38,58,39,34,13,20,41,26,0,"1","1",19,29,15,32,4,36,66,44,26,61,44,21,67,31,29,39,33,21,0,6,14,61,18,43,40,32,10,40,25,43,62,57,31,"0",40,70,36,31,1,23,"1","3",18,3,46,"1",45,52,16,26,61,4,34,3,32,"2","2",19,12,7,51,"49",25
"2014-12-01",45,26,1,56,2,44,31,25,15,5,29,54,0,18,26,4,49,43,13,37,42,46,21,"1",7,21,47,3,9,19,54,43,70,37,49,49,25,6,48,48,52,51,2,35,35,0,52,34,28,24,44,21,26,35,10,7,26,29,19,50,62,34,77,11,19,39,51,63,6,8,11,0,60,46,5,6,"64",9,74,73,39,82,29,72,21,3,0,40,23,27,17,52,62,37,3,1,"0","0","<1",6,4,16,"<1","1",2,"1",20,5,46,"<1",14,16,26,16,10,27,43,33,32,22,56,49,"5",18,22,37,46,48,40,28,8,48,5,24,31,61,45,7,17,5,38,43,39,53,66,6,1,44,39,7,6,24,22,52,30,17,50,54,6,1,33,21,20,14,2,38,6,16,46,38,17,43,64,41,24,19,21,45,28,0,"<1","<1",25,30,14,30,5,38,56,34,25,61,45,24,64,34,24,37,37,23,4,5,15,57,19,50,34,29,17,46,16,39,68,55,34,"0",40,67,34,29,1,21,"<1","1",15,3,41,"1",54,58,16,36,57,3,33,4,31,"1","2",7,13,8,56,"47",18
"2015-01-01",50,33,1,70,3,50,30,26,16,2,25,60,6,22,30,5,54,44,19,37,49,48,26,"1",9,24,66,2,8,21,65,53,73,47,45,58,32,5,55,53,57,59,4,39,51,0,54,30,32,25,48,32,32,35,21,11,38,35,21,74,84,37,73,23,17,44,52,61,12,8,17,12,61,46,5,12,"87",6,39,65,26,77,27,73,28,2,3,41,6,29,25,61,56,35,4,1,"1","<1","<1",6,7,16,"<1","<1",1,"0",21,6,55,"<1",15,21,36,24,9,25,59,38,37,34,64,63,"8",14,18,49,47,57,35,34,5,44,4,21,19,76,63,13,8,6,43,51,43,40,73,6,2,59,44,12,6,31,29,58,19,18,56,62,7,2,41,14,25,15,2,42,6,23,45,45,17,51,63,54,25,14,23,49,29,9,"<1","<1",26,30,19,36,8,44,47,34,30,70,65,32,88,50,34,46,53,32,0,4,15,73,23,48,39,29,16,35,21,42,66,73,36,"0",40,82,45,27,0,22,"1","1",14,1,41,"1",48,55,13,32,67,5,36,4,50,"2","1",30,17,7,67,"61",20
"2015-02-01",55,36,0,62,2,60,45,39,10,1,27,67,6,20,33,2,49,49,16,39,53,62,24,"1",15,24,63,0,11,17,67,57,72,30,42,61,26,3,78,57,68,69,4,48,45,0,70,24,31,22,54,31,36,37,21,7,39,40,17,66,71,46,76,24,10,41,70,58,10,8,14,19,63,46,5,7,"86",7,39,55,20,73,24,69,17,3,0,45,10,28,25,53,51,50,1,1,"<1","<1","<1",7,7,16,"1","0",0,"1",23,6,58,"<1",12,14,35,20,11,31,51,41,39,29,68,57,"13",10,22,35,52,59,62,39,20,62,5,18,28,70,61,12,12,6,45,48,42,65,61,13,3,55,47,13,12,32,24,57,21,21,51,60,8,4,41,13,22,14,2,57,7,13,52,45,12,45,63,56,39,10,25,47,31,5,"1","0",20,32,21,32,7,43,80,43,29,53,64,25,88,37,32,46,48,32,0,7,17,74,18,36,34,36,13,40,13,45,78,66,36,"0",28,83,37,36,1,16,"1","1",16,2,46,"0",58,62,11,30,64,5,41,2,49,"1","1",24,16,8,71,"61",15
"2015-03-01",54,28,1,54,0,54,34,27,16,2,23,65,12,15,28,0,53,46,17,43,50,59,25,"1",11,24,69,0,11,18,70,55,72,24,50,68,33,9,53,56,61,71,2,46,44,6,66,25,31,24,52,25,36,38,23,8,38,38,18,69,66,39,71,24,4,40,64,58,12,10,21,12,61,45,7,22,"89",7,37,54,23,78,29,68,17,5,3,50,15,30,24,61,58,47,4,1,"<1","<1","<1",5,6,15,"1","<1",0,"0",21,6,57,"<1",17,13,36,14,6,28,54,47,43,31,71,87,"5",16,25,32,53,58,49,37,5,60,5,19,27,67,62,15,18,6,43,50,42,72,72,7,4,51,46,17,11,34,31,60,26,19,55,64,6,1,41,19,22,13,2,47,6,18,60,46,13,45,59,56,33,14,24,52,31,5,"1","<1",16,34,19,32,7,46,78,43,34,59,61,26,90,59,36,51,53,27,0,5,8,80,19,37,40,35,12,41,20,36,84,67,34,"0",43,86,44,32,0,18,"1","3",16,3,43,"0",50,59,15,42,66,4,34,3,53,"2","1",7,18,10,76,"68",14
"2015-04-01",54,24,0,54,3,65,42,32,13,2,15,70,6,24,34,4,69,55,23,42,51,62,30,"1",16,25,81,3,10,25,63,51,68,31,45,73,29,5,72,59,61,73,1,49,41,0,68,26,25,22,53,19,33,39,21,10,37,39,25,66,82,46,72,25,4,44,67,59,0,11,22,19,66,53,6,16,"89",7,50,55,24,79,31,68,17,5,9,56,19,28,27,62,60,52,1,1,"<1","<1","<1",6,7,13,"1","<1",1,"0",21,6,56,"<1",16,11,38,18,8,30,54,39,49,31,63,73,"8",21,20,25,58,43,58,38,17,61,5,27,17,71,59,16,10,4,43,50,43,60,66,7,5,47,48,13,11,33,34,61,18,23,50,68,4,2,47,15,22,10,8,37,5,18,61,51,11,52,68,42,34,19,22,53,26,0,"1","<1",15,31,7,25,4,47,80,50,32,55,73,34,88,78,38,52,45,22,9,4,13,85,20,38,36,44,11,45,19,36,73,70,34,"0",28,80,46,37,1,22,"1","1",16,3,44,"2",55,65,9,33,65,5,29,4,53,"2","2",19,16,9,74,"73",12
"2015-05-01",49,23,1,55,2,50,34,24,7,6,20,60,6,22,27,4,69,59,15,49,45,47,27,"1",11,20,87,5,7,23,68,57,70,27,62,73,34,10,67,55,56,78,1,36,41,0,52,23,30,24,48,19,29,34,19,7,38,31,23,72,63,38,70,22,12,48,54,58,13,10,13,25,65,57,5,10,"89",5,38,64,25,84,30,75,16,4,3,49,20,31,19,59,61,39,3,1,"0","0","<1",7,7,12,"1","1",0,"0",18,5,51,"<1",13,12,37,14,7,33,55,42,38,29,73,74,"5",14,19,30,49,35,41,29,14,51,3,22,23,77,56,15,18,4,39,44,45,56,73,7,6,49,44,15,12,34,25,65,14,21,54,61,9,3,38,12,24,12,3,36,5,16,45,42,9,44,57,48,37,21,19,57,25,0,"1","<1",19,25,13,21,5,44,58,36,32,57,65,29,91,49,41,50,51,28,5,4,18,89,17,41,38,31,20,36,18,38,60,70,34,"0",34,77,41,33,3,19,"1","2",13,2,39,"2",41,53,7,35,64,1,29,3,59,"2","1",12,14,8,83,"76",12
"2015-06-01",43,21,1,46,0,38,24,19,10,3,22,61,0,32,24,6,61,58,17,48,45,41,29,"1",9,22,70,0,8,24,76,55,73,28,54,82,29,5,63,58,55,81,4,34,34,0,42,25,23,28,49,23,28,20,14,12,41,32,24,72,65,29,76,25,12,44,55,55,7,7,15,13,61,56,4,17,"93",7,49,67,28,92,38,78,13,2,7,39,10,33,21,68,73,27,2,1,"<1","<1","<1",5,5,13,"<1","0",0,"0",20,4,53,"<1",12,12,31,15,13,31,57,50,37,25,94,87,"4",11,17,40,38,43,38,21,18,31,4,14,23,78,63,21,12,5,24,43,47,73,91,3,3,50,45,10,11,35,20,73,25,23,49,51,10,2,23,13,30,14,4,29,7,13,50,40,9,48,64,64,23,13,23,60,25,0,"<1","0",23,24,10,22,7,52,39,27,31,62,71,24,94,68,44,54,74,32,9,2,19,90,17,43,37,28,21,42,30,44,61,72,37,"<1",37,78,49,23,0,15,"<1","2",14,3,39,"1",37,38,5,38,66,6,33,5,52,"2","1",13,20,9,86,"78",11
"2015-07-01",48,21,1,41,2,37,22,11,7,4,25,62,7,34,25,6,71,68,20,52,46,39,28,"1",7,22,83,5,8,25,88,57,81,32,47,75,33,3,54,56,54,84,2,36,37,0,38,30,27,26,48,32,27,20,14,16,43,27,25,77,61,29,83,21,11,49,49,56,7,7,15,7,66,57,4,14,"100",7,40,70,33,100,40,83,13,1,0,40,7,33,25,71,71,28,1,1,"0","<1","<1",3,3,13,"<1","<1",0,"0",20,5,50,"<1",14,10,27,19,12,31,53,60,39,30,97,100,"2",9,21,35,40,38,33,25,0,36,3,22,29,85,58,15,13,8,22,44,46,77,95,3,2,47,43,21,9,38,21,83,22,20,55,62,12,1,18,18,32,15,4,31,5,16,43,42,9,57,70,59,20,27,26,66,38,0,"<1","<1",15,25,9,24,9,56,38,27,31,65,76,27,100,74,47,67,69,32,9,3,12,93,31,57,37,22,16,48,28,48,64,75,41,"<1",43,77,51,23,1,20,"<1","3",12,2,42,"0",36,44,7,36,76,4,31,2,51,"1","1",5,10,10,87,"85",12
"2015-08-01",47,24,0,46,2,41,16,19,8,1,28,58,0,32,22,2,58,67,20,50,46,37,27,"1",7,22,86,3,6,25,73,58,78,49,45,66,33,6,48,54,53,80,2,35,48,0,39,30,25,29,50,25,31,22,15,7,37,29,25,77,59,29,76,21,12,39,49,60,19,7,12,0,67,50,6,7,"93",7,46,70,29,92,36,83,14,4,3,41,7,34,24,72,69,22,2,1,"0","<1","<1",0,5,15,"<1","<1",1,"0",20,4,52,"<1",11,12,36,16,7,37,60,48,38,30,96,73,"3",9,25,44,39,35,34,22,15,32,3,27,19,78,60,20,20,5,24,47,47,65,78,3,4,50,42,15,8,40,24,79,24,14,60,62,5,2,28,11,26,12,4,36,5,17,47,41,10,48,71,45,22,18,20,63,37,0,"<1","<1",14,25,10,24,7,61,32,24,32,68,75,33,93,60,41,57,50,25,5,1,15,91,14,53,41,25,15,52,19,43,60,76,40,"0",34,77,50,22,0,32,"<1","1",13,1,38,"0",37,41,7,36,82,4,30,5,49,"1","1",12,14,7,94,"84",9
"2015-09-01",55,16,2,47,2,51,27,18,7,2,26,66,0,18,42,0,57,60,15,43,52,61,25,"1",9,23,73,2,9,18,64,54,68,45,41,67,31,10,60,59,61,72,2,40,43,0,71,28,23,25,52,26,32,39,21,10,30,42,18,68,70,39,69,19,6,46,73,56,18,11,19,18,64,52,7,13,"79",5,40,62,26,83,31,73,13,6,0,52,13,30,19,62,71,49,1,1,"1","<1","<1",5,7,14,"1","1",0,"1",20,5,59,"<1",16,16,38,17,5,31,55,38,40,27,84,88,"5",14,22,38,52,44,70,37,6,48,3,24,24,77,55,17,14,7,42,48,43,63,81,5,2,54,47,10,7,38,31,69,22,19,57,64,9,2,50,16,23,12,3,49,5,15,54,49,10,46,59,38,35,21,20,52,42,0,"1","1",14,34,15,18,4,50,62,44,27,55,61,33,79,72,31,49,38,19,0,4,11,79,18,44,39,35,12,52,12,35,87,72,38,"<1",37,76,46,43,1,16,"1","2",18,2,47,"0",53,61,8,33,64,6,33,4,42,"2","1",7,14,7,89,"72",13
"2015-10-01",59,18,2,49,1,65,38,21,12,2,29,66,6,12,34,2,60,56,12,43,52,63,25,"1",15,25,71,2,11,23,58,45,68,30,43,65,29,8,57,60,65,61,2,49,39,3,74,28,20,22,53,24,37,36,22,13,25,40,23,66,67,40,70,24,8,39,66,54,12,10,19,18,70,52,8,12,"73",7,31,59,24,78,30,74,13,4,9,56,21,34,17,71,63,47,1,1,"<1","<1","<1",10,10,16,"1","1",0,"1",21,6,60,"<1",13,14,35,25,5,29,55,33,39,31,83,81,"7",14,24,58,52,65,70,32,13,57,4,23,18,73,50,16,15,6,47,52,44,53,67,6,4,50,47,13,9,37,31,60,27,17,52,65,5,2,47,20,25,15,4,37,7,13,58,52,14,48,59,46,39,9,22,54,38,0,"1","1",20,37,14,18,6,40,82,54,27,62,65,29,74,55,26,42,32,17,8,3,15,74,17,51,35,39,11,45,17,29,79,66,35,"0",45,73,44,42,1,21,"1","1",17,3,48,"0",58,60,12,41,62,3,23,5,31,"1","3",16,20,10,85,"69",12
"2015-11-01",53,15,2,42,0,58,41,27,24,4,33,59,0,16,29,3,60,61,11,38,48,52,20,"1",14,21,73,2,9,24,51,48,65,32,41,54,29,9,53,51,56,71,2,46,42,0,66,27,26,21,50,23,31,39,20,9,24,38,24,60,80,41,67,16,14,38,59,51,12,12,12,18,70,50,7,22,"68",6,44,60,25,80,32,69,12,2,9,50,16,29,18,67,65,47,1,1,"0","0","<1",5,6,19,"1","1",0,"0",21,6,59,"<1",12,8,33,24,4,29,42,28,31,28,58,67,"3",16,21,54,51,47,58,32,22,54,4,24,26,62,42,12,16,5,47,44,39,49,76,5,2,49,43,9,8,28,27,56,25,13,51,56,6,3,44,18,23,14,3,36,7,12,51,46,10,37,63,37,28,15,23,48,37,0,"1","1",15,29,16,20,7,49,70,53,25,60,45,29,69,45,26,38,30,20,9,5,19,68,17,39,30,36,13,43,19,32,82,58,31,"0",30,68,39,48,5,23,"1","3",17,2,47,"2",54,54,10,41,59,3,18,5,27,"2","2",28,20,8,66,"63",12
"2015-12-01",48,14,0,48,0,48,28,24,8,5,35,54,0,14,34,4,48,52,16,49,42,45,22,"1",9,19,62,2,7,20,53,46,67,44,44,53,29,8,56,48,53,62,3,33,29,0,51,24,18,20,43,26,27,30,16,11,23,30,20,58,72,28,70,16,12,35,51,50,18,9,16,12,65,44,5,22,"63",7,54,67,35,80,28,68,12,3,3,44,24,27,15,59,58,38,1,1,"0","<1","<1",4,4,16,"1","1",0,"0",19,6,50,"<1",9,14,26,27,6,26,40,31,38,29,64,57,"6",14,24,59,49,45,38,27,16,47,3,16,21,61,49,12,17,6,39,42,41,56,78,7,6,43,38,8,6,32,22,55,18,14,44,57,6,2,36,13,25,17,2,35,5,10,38,30,12,40,61,43,25,13,21,54,32,9,"1","1",14,29,15,22,5,43,67,39,27,59,52,23,64,46,27,39,33,17,8,5,12,64,17,47,31,29,15,48,26,30,72,56,33,"<1",33,65,35,32,1,25,"<1","<1",15,2,41,"0",47,55,10,40,53,2,28,4,27,"1","1",13,11,8,58,"60",15
"2016-01-01",53,23,1,60,2,58,17,20,6,2,15,56,5,15,35,2,68,55,18,51,52,42,26,"1",11,21,81,0,11,20,68,54,75,54,52,69,28,4,56,50,52,71,1,45,39,0,52,34,23,21,44,24,26,35,16,11,31,35,20,83,84,36,62,19,14,39,57,53,10,9,14,15,67,54,5,18,"85",6,41,58,24,70,24,62,18,0,0,47,18,24,22,61,61,37,3,1,"1","0","<1",3,6,17,"1","1",0,"0",21,5,53,"<1",15,14,29,19,8,30,59,34,41,32,64,62,"5",9,20,71,48,59,50,33,9,40,3,18,13,72,53,16,14,4,43,50,37,54,69,4,3,49,47,15,9,41,24,66,16,9,54,64,10,2,44,13,25,15,3,37,6,18,47,42,12,43,62,44,27,10,27,58,36,0,"1","1",14,31,19,29,14,49,43,37,32,68,67,33,84,54,30,44,40,30,0,4,7,80,15,44,36,27,21,52,20,32,71,69,33,"<1",34,75,46,31,1,28,"<1","1",14,2,41,"1",40,45,10,31,63,5,27,4,43,"1","1",24,19,8,67,"70",26
"2016-02-01",61,21,0,51,1,74,34,29,5,2,25,67,0,14,43,2,58,58,21,55,57,60,26,"1",13,22,83,0,12,18,71,62,80,87,50,71,30,7,72,56,66,83,3,42,45,0,75,32,25,23,54,22,30,36,17,12,32,39,18,83,79,47,66,19,14,48,72,55,15,11,18,25,75,55,8,11,"87",5,39,51,23,64,26,60,16,1,5,53,23,25,22,71,66,57,3,2,"0","<1","<1",3,7,16,"2","1",1,"1",22,5,60,"<1",22,16,33,21,9,29,49,36,44,35,68,57,"2",14,19,52,54,57,85,48,25,59,3,15,21,68,52,12,7,4,50,57,39,71,86,5,4,46,53,15,10,41,38,70,15,10,52,63,11,2,45,11,24,12,5,44,6,12,57,47,10,39,58,47,34,12,25,60,29,4,"2","1",13,37,15,27,11,47,86,62,32,66,86,21,89,70,29,46,42,31,7,5,10,86,18,35,31,38,17,48,16,29,88,63,33,"0",39,78,43,51,3,26,"<1","1",18,2,45,"1",51,55,9,36,59,9,35,5,39,"2","1",6,23,8,80,"74",35
"2016-03-01",55,13,1,48,1,65,41,31,10,3,23,64,0,15,37,2,67,63,16,58,56,53,29,"1",11,21,84,0,12,18,76,57,76,89,51,90,32,5,62,56,58,79,2,39,32,2,69,30,17,19,52,21,29,31,19,15,32,39,18,91,80,44,62,19,10,41,61,53,7,12,18,14,71,56,6,0,"88",4,49,52,23,68,29,61,12,3,7,57,29,24,17,72,65,54,4,1,"0","<1","<1",7,6,18,"1","1",0,"0",21,6,60,"<1",14,16,31,17,6,34,57,38,47,35,74,73,"4",13,20,50,51,55,68,36,19,56,4,18,17,66,46,13,13,4,43,55,41,45,87,5,3,46,52,17,11,41,26,70,23,9,55,59,8,0,41,17,24,10,2,37,6,12,57,43,11,44,65,50,34,9,23,64,32,4,"1","1",16,33,10,26,9,51,81,60,34,60,76,29,88,90,37,48,41,24,3,3,8,93,11,33,33,38,27,46,20,26,85,64,33,"0",45,83,39,45,2,23,"<1","2",17,2,44,"0",43,52,8,32,63,2,31,3,37,"2","2",4,23,9,88,"79",33
"2016-04-01",57,16,2,55,2,76,47,36,5,2,26,67,0,16,46,2,75,74,19,62,53,55,29,"1",16,19,88,0,10,22,70,58,75,55,49,77,29,7,63,55,54,90,2,46,41,0,72,27,17,21,47,19,28,38,17,13,30,38,22,90,76,47,63,22,22,40,64,50,15,12,20,34,72,62,8,18,"91",1,50,55,21,76,30,66,13,2,5,59,38,22,21,86,62,61,2,1,"<1","<1","<1",6,7,14,"1","<1",0,"<1",20,6,62,"<1",15,16,32,11,4,29,51,35,52,37,75,75,"3",22,21,47,56,54,70,40,20,58,4,9,17,65,47,16,18,5,45,54,42,55,76,4,2,47,53,13,10,44,36,75,15,12,50,66,7,3,41,13,25,10,5,35,5,13,61,44,12,37,63,41,31,16,21,66,29,4,"1","1",13,32,9,24,9,50,86,63,34,63,73,30,89,87,32,51,42,21,10,4,7,98,13,33,36,44,17,44,22,32,100,71,34,"<1",39,75,45,43,0,27,"<1","3",18,3,46,"1",48,62,8,28,60,3,36,2,34,"1","2",8,23,6,81,"84",21
"2016-05-01",49,10,1,46,0,60,26,21,12,1,24,56,5,21,36,5,63,69,18,65,50,44,27,"1",9,19,71,0,10,21,75,57,77,38,48,91,26,8,64,51,52,84,2,31,38,0,51,24,20,19,44,22,26,33,15,12,31,30,21,93,65,36,63,20,22,43,53,51,10,11,16,20,72,65,10,10,"93",3,53,57,25,77,27,64,12,3,0,54,25,25,19,70,69,40,4,1,"1","0","<1",12,7,12,"<1","<1",1,"0",19,6,53,"<1",16,19,32,12,10,28,50,39,42,33,74,71,"3",16,20,49,49,44,58,33,11,46,3,15,14,68,54,14,10,5,40,47,43,56,85,4,2,48,49,13,11,48,26,73,13,11,47,65,9,6,42,16,26,11,4,37,5,16,46,40,12,47,60,43,25,17,22,66,27,0,"<1","<1",13,26,7,20,3,47,63,49,34,61,71,28,92,79,37,51,49,26,3,3,9,96,12,35,33,32,26,45,18,32,92,70,34,"<1",43,71,43,32,1,21,"<1","1",14,2,39,"1",35,46,7,31,61,4,35,2,38,"1","2",6,18,9,79,"81",23
"2016-06-01",45,10,1,42,3,44,24,23,0,2,24,58,0,24,29,0,78,76,14,64,47,36,28,"1",10,19,86,4,7,24,84,58,81,42,56,92,27,8,49,52,50,87,0,25,33,0,40,24,23,22,45,22,22,23,11,11,31,26,24,85,66,28,65,16,20,42,46,53,5,11,17,5,73,63,13,8,"92",3,44,62,27,74,34,68,11,1,3,45,27,22,19,72,74,29,2,1,"<1","0","<1",2,3,11,"1","<1",1,"1",19,4,48,"<1",10,9,24,12,9,29,51,43,41,30,84,73,"2",10,25,37,41,29,43,26,16,30,2,17,12,73,47,16,11,4,25,41,41,49,98,3,2,43,45,15,9,42,20,85,21,9,49,51,8,3,23,12,28,10,1,29,5,12,47,35,7,39,64,50,22,16,21,72,32,0,"1","1",12,27,9,19,3,52,40,39,33,68,79,26,92,78,37,54,58,35,4,2,12,93,23,43,30,24,30,47,20,34,67,72,37,"0",37,71,46,23,1,20,"<1","1",11,1,37,"<1",31,35,5,26,62,4,32,2,36,"1","1",8,22,10,93,"82",26
"2016-07-01",41,10,0,38,3,50,26,18,9,1,15,51,0,29,20,2,78,78,15,71,47,31,25,"1",5,21,79,0,7,16,83,58,84,32,49,86,31,8,53,47,43,77,1,24,36,2,33,23,21,21,38,17,21,17,9,12,32,24,16,94,57,23,62,19,27,44,40,53,10,7,8,5,64,62,8,5,"93",2,38,64,25,76,34,65,9,2,0,42,8,26,18,76,70,25,1,2,"1","0","<1",2,3,12,"<1","0",0,"0",17,4,46,"<1",8,11,21,19,5,27,47,47,37,31,83,87,"3",7,19,46,36,31,35,28,9,31,1,13,15,70,50,18,11,4,19,40,41,48,87,3,2,41,41,10,12,46,21,91,15,10,52,53,11,5,16,14,22,8,1,26,4,12,39,33,6,43,63,52,19,23,23,80,26,0,"<1","1",13,23,10,23,6,55,37,29,31,65,68,24,91,77,38,52,54,27,0,2,7,92,15,45,32,19,30,48,15,33,54,68,35,"0",38,68,44,16,1,16,"<1","1",10,1,31,"0",26,32,3,35,64,2,36,2,34,"1","1",4,18,6,100,"82",25
"2016-08-01",42,12,1,34,1,44,18,10,3,1,18,53,0,23,22,2,72,80,16,59,46,32,23,"1",6,19,80,0,6,24,70,51,77,31,48,71,28,9,58,48,47,78,1,33,44,2,37,24,20,23,42,20,22,19,11,10,27,29,24,84,59,28,65,18,14,37,44,53,5,11,13,0,61,53,6,11,"82",3,49,56,24,68,28,60,10,2,0,34,11,34,18,82,65,22,2,2,"0","0","<1",2,4,12,"<1","1",1,"<1",19,4,46,"<1",13,9,28,13,8,28,51,35,34,27,76,68,"2",7,21,37,42,39,30,22,0,25,2,11,15,68,42,13,16,5,23,41,41,62,78,3,1,45,45,15,13,47,24,81,12,7,49,54,8,4,26,17,25,9,3,27,5,13,39,39,7,39,66,33,17,20,23,69,22,0,"<1","1",12,20,25,32,14,55,25,25,30,62,78,23,83,75,32,47,35,30,4,2,9,84,15,38,30,20,27,31,22,37,57,69,36,"0",41,68,42,22,0,17,"<1","1",11,2,35,"1",28,33,5,35,65,2,23,2,31,"1","1",2,10,11,86,"79",21
"2016-09-01",51,8,0,47,2,52,24,25,4,1,23,60,0,14,45,0,69,65,18,58,52,51,25,"1",10,20,88,2,8,19,65,49,71,41,50,69,29,7,52,51,57,75,3,42,37,0,65,25,24,21,45,21,27,34,18,11,24,37,19,76,64,40,60,17,26,36,65,48,5,11,14,34,69,53,8,8,"77",3,46,57,23,70,27,62,14,2,5,51,5,27,15,76,62,48,2,1,"0","0","<1",10,6,13,"1","1",0,"0",19,6,56,"<1",15,15,29,13,5,29,48,29,37,30,76,65,"2",9,22,53,53,39,73,42,31,45,5,20,14,61,45,15,13,5,38,48,41,50,75,4,2,51,48,16,11,45,28,75,15,10,47,55,7,5,44,16,23,11,1,41,6,17,53,47,9,33,60,35,29,14,23,65,25,0,"1","1",11,30,20,22,4,54,56,52,28,57,60,27,77,67,28,40,37,21,7,2,8,78,23,41,31,30,21,45,14,30,76,62,31,"<1",39,67,40,39,1,17,"<1","1",14,1,40,"<1",42,49,7,33,56,3,33,2,27,"1","1",13,12,7,77,"70",26
"2016-10-01",55,9,1,39,0,61,41,32,3,1,25,58,0,12,37,3,64,67,14,55,52,53,24,"1",12,24,66,4,9,18,64,51,74,27,54,67,26,15,61,49,58,72,1,41,35,0,67,22,25,21,45,18,26,32,16,10,22,38,18,77,76,42,58,16,19,33,60,48,12,13,15,38,71,58,7,20,"71",3,49,54,23,72,24,60,11,3,5,49,20,27,14,72,67,54,2,2,"<1","0","<1",8,7,15,"1","3",0,"1",20,6,58,"<1",14,10,28,16,5,21,45,30,41,28,70,69,"5",9,22,71,50,51,67,35,13,57,3,17,15,59,43,11,8,3,41,43,38,49,81,4,3,49,48,9,11,41,27,70,21,9,64,56,9,4,37,14,22,13,1,35,6,14,46,45,9,34,52,30,33,15,22,63,27,0,"1","3",10,30,13,27,5,43,76,58,28,52,59,22,70,81,28,40,28,14,0,3,8,74,19,38,28,33,19,45,11,28,85,59,31,"0",30,65,38,48,1,15,"1","1",18,2,44,"1",50,51,8,34,56,5,28,5,23,"1","1",9,17,4,79,"69",30
"2016-11-01",54,9,1,48,0,63,38,30,10,1,23,57,0,10,43,2,46,54,13,57,54,46,24,"1",11,25,66,0,8,22,60,46,72,21,41,65,24,7,62,50,50,68,2,35,34,0,60,21,23,18,43,22,23,34,15,10,20,35,22,67,71,41,56,16,23,39,52,49,19,12,15,33,78,53,8,15,"63",3,56,60,26,68,28,65,11,1,2,55,22,24,14,66,67,46,4,1,"0","0","<1",7,7,19,"1","3",0,"<1",21,7,60,"<1",17,17,25,19,8,27,44,24,43,33,66,53,"1",13,15,76,51,61,59,36,30,55,4,13,22,58,38,11,14,5,45,43,35,50,63,3,2,55,49,9,11,40,23,63,22,8,46,51,6,3,41,16,23,15,2,32,6,9,53,43,10,31,52,32,25,13,21,57,35,0,"1","3",11,29,11,30,7,40,74,58,29,60,57,25,63,49,28,37,26,21,7,6,9,66,13,38,28,30,14,44,18,26,78,57,30,"<1",43,63,33,44,4,22,"<1","2",18,2,47,"<1",43,56,9,29,51,3,28,4,21,"2","2",5,16,6,64,"61",9
"2016-12-01",50,9,1,43,3,56,26,20,5,2,30,53,0,14,41,2,58,67,13,64,46,39,20,"1",11,17,75,2,8,20,61,52,75,30,48,65,25,5,53,44,49,75,2,37,31,0,49,23,18,19,43,20,20,26,13,8,19,29,20,66,65,40,61,14,17,34,46,50,14,10,16,14,74,55,5,19,"61",4,68,68,36,69,27,59,11,1,7,52,17,27,14,66,49,44,2,1,"0","0","<1",6,7,14,"1","<1",0,"<1",18,5,48,"<1",20,11,23,18,6,26,42,27,39,30,49,57,"4",12,21,65,46,48,55,33,23,47,3,18,18,53,38,12,10,5,37,42,40,58,70,4,2,40,42,7,10,40,24,61,22,9,49,53,7,1,33,14,25,11,3,35,4,12,43,35,9,31,56,32,20,15,22,59,31,0,"1","<1",12,29,17,28,7,46,65,46,28,57,53,21,63,57,21,35,27,18,3,2,10,63,9,53,23,28,18,43,14,26,77,52,31,"0",32,59,32,32,1,21,"<1","1",13,2,38,"2",40,50,8,32,50,4,33,2,19,"1","1",16,14,7,55,"61",24
"2017-01-01",54,13,1,52,0,61,31,21,7,1,23,59,0,10,32,1,75,70,16,59,56,41,25,"1",15,28,81,0,9,20,67,52,76,26,40,78,26,14,63,52,50,79,2,37,42,0,52,28,19,22,46,20,30,33,15,7,28,31,20,88,82,32,57,17,18,38,56,53,11,10,18,9,78,57,6,16,"84",3,63,61,29,75,32,68,13,2,4,51,14,29,17,83,60,39,2,2,"<1","<1","<1",10,9,19,"1","1",0,"<1",22,8,59,"<1",17,19,30,11,9,26,59,31,44,33,66,67,"3",13,19,58,51,45,53,38,16,44,4,15,17,66,51,16,11,4,42,50,38,53,83,4,2,51,51,12,10,47,31,69,15,9,57,63,11,2,41,15,26,16,1,31,7,13,46,42,13,36,61,42,26,9,22,61,51,0,"1","<1",11,29,44,33,29,54,49,40,31,63,99,32,85,65,33,43,43,34,0,3,15,77,10,42,35,28,16,38,19,33,73,70,31,"1",40,73,42,37,3,22,"1","1",18,2,46,"2",41,46,11,51,61,3,32,4,33,"1","1",12,16,9,67,"78",49
"2017-02-01",61,10,1,46,1,83,41,36,7,4,28,67,0,18,48,2,65,70,18,66,59,56,26,"1",15,27,86,3,11,23,68,54,75,30,41,77,24,14,71,57,65,84,2,46,39,0,70,29,28,26,52,22,30,29,21,10,28,38,23,82,83,43,61,19,20,39,71,50,14,13,20,9,77,60,9,15,"86",4,55,57,23,74,22,64,12,1,7,58,22,27,17,79,66,62,4,2,"0","0","<1",7,10,15,"1","<1",0,"0",20,7,64,"<1",17,22,31,21,5,27,47,30,52,36,66,67,"3",14,17,46,56,52,91,43,26,68,3,15,21,58,43,14,12,5,46,54,37,48,79,5,3,50,53,10,12,45,32,71,17,14,49,64,8,3,44,12,28,13,1,43,7,10,60,49,13,33,61,40,34,14,24,69,34,4,"1","<1",10,36,41,27,18,61,89,70,35,54,74,27,86,51,30,47,37,26,3,3,7,82,10,34,32,37,22,49,24,32,86,62,33,"0",35,77,36,44,2,22,"<1","1",18,2,47,"1",44,56,10,34,58,4,33,2,30,"1","1",9,17,8,79,"81",41
"2017-03-01",60,10,4,42,0,66,45,37,8,2,28,65,0,16,42,1,82,73,15,72,55,52,28,"11",20,43,86,3,12,22,76,53,79,26,45,85,28,6,70,56,59,86,4,46,39,0,67,27,23,24,52,23,28,35,19,16,28,38,22,91,75,44,58,21,24,42,61,50,15,15,15,17,79,65,9,15,"87",3,71,56,26,71,30,66,13,1,2,57,24,28,16,82,65,54,4,11,"2","2","9",16,12,40,"2","1",1,"1",31,11,64,"1",32,13,33,15,5,28,48,35,54,36,75,74,"2",16,25,53,57,61,71,39,38,63,5,17,19,59,50,14,10,5,43,56,39,49,77,5,2,46,54,10,10,50,32,75,16,8,47,61,11,3,44,15,30,64,5,35,27,14,57,47,9,37,60,46,33,13,21,76,33,0,"2","1",11,38,36,41,13,61,87,59,34,57,85,29,86,84,33,47,38,25,0,3,8,92,16,42,32,38,18,55,16,31,78,62,31,"3",32,78,35,48,6,23,"4","2",26,3,53,"8",54,57,8,35,59,11,29,3,31,"3","3",10,27,8,87,"86",25
"2017-04-01",57,8,1,47,1,86,43,29,2,1,24,64,0,11,44,0,86,76,17,75,53,51,27,"2",16,27,89,4,12,22,72,52,75,31,49,91,27,10,75,53,56,87,3,38,34,0,66,26,20,19,48,19,26,31,14,10,28,37,22,96,80,45,58,19,23,42,63,52,14,15,18,32,77,68,8,5,"85",4,59,61,28,73,31,67,14,2,5,66,26,31,16,77,67,60,1,3,"0","<1","1",9,8,15,"1","<1",0,"<1",21,7,65,"<1",21,18,32,20,5,26,46,30,56,40,82,74,"3",19,18,52,55,72,72,44,21,65,4,17,22,60,48,16,8,4,41,52,39,53,75,5,1,45,54,16,12,51,34,76,13,9,50,63,11,3,42,9,30,16,3,30,8,13,54,46,11,41,59,42,29,22,23,79,24,0,"1","<1",12,36,12,31,9,63,95,67,36,52,88,38,85,87,34,45,38,23,13,3,11,91,16,41,30,39,24,51,13,35,90,65,33,"1",32,71,41,46,2,18,"1","3",18,3,48,"2",50,58,10,35,57,3,34,2,31,"2","3",12,21,9,93,"88",20
"2017-05-01",51,7,3,44,1,56,23,22,8,2,24,58,5,16,33,2,83,81,18,73,49,43,28,"10",16,35,100,2,10,19,72,51,75,26,42,79,30,7,54,70,52,89,2,34,41,2,51,19,21,21,46,25,24,30,17,17,26,32,19,83,69,37,60,20,18,44,53,52,11,13,19,23,82,73,6,9,"86",4,57,64,26,82,36,70,11,2,2,60,24,31,15,80,70,44,3,11,"4","3","9",8,10,23,"1","2",1,"<1",27,14,55,"1",26,16,32,9,3,31,48,29,49,35,69,73,"4",13,18,46,52,42,53,31,25,50,4,16,17,60,50,17,9,6,39,47,40,48,86,4,3,45,49,12,11,56,30,82,13,12,49,60,10,3,38,14,27,41,4,29,17,12,52,41,9,38,56,38,28,17,21,73,25,0,"1","2",12,38,16,29,8,60,67,45,32,48,89,30,85,84,37,47,45,23,3,5,10,92,12,43,32,31,31,46,10,37,83,68,29,"4",38,68,40,40,9,19,"6","3",21,3,46,"10",41,53,7,40,61,7,35,3,30,"2","3",10,26,6,83,"87",25
"2017-06-01",47,6,3,46,1,43,26,15,3,1,28,55,0,12,25,2,87,82,16,84,46,33,27,"9",11,32,93,2,8,22,83,52,84,28,47,89,26,9,57,59,49,96,2,23,42,0,37,25,22,22,44,20,20,19,13,12,27,28,22,91,64,29,64,18,34,41,44,53,7,9,11,34,78,73,5,10,"90",2,72,70,27,82,33,72,9,1,7,48,10,31,14,94,65,32,6,10,"3","4","8",7,7,17,"2","2",1,"<1",23,9,49,"<1",23,10,25,25,6,27,51,38,43,31,81,99,"5",7,20,46,41,36,42,26,9,32,3,22,12,62,52,15,9,7,24,42,40,49,90,4,2,41,48,17,15,61,20,88,17,14,49,48,12,6,21,22,34,19,2,27,16,10,40,38,7,39,60,41,24,23,22,84,27,0,"2","2",11,36,16,34,9,58,42,32,31,56,96,30,89,90,44,54,50,29,0,1,17,93,10,44,34,25,29,36,16,36,66,70,36,"4",38,68,42,20,9,26,"4","1",16,2,40,"9",27,36,6,42,61,7,22,3,28,"1","1",7,22,8,89,"88",11
"2017-07-01",44,6,4,48,5,48,24,19,5,3,30,55,5,22,21,3,94,92,22,91,46,29,29,"8",8,39,91,2,8,20,89,58,86,24,47,90,31,22,49,48,46,88,2,26,35,0,32,27,22,21,41,23,19,15,9,13,32,25,20,99,67,25,65,21,32,47,38,53,0,8,9,10,78,72,3,5,"91",2,64,68,28,89,38,76,10,2,2,43,15,26,17,87,64,28,2,9,"1","1","7",6,6,16,"2","2",0,"<1",25,7,48,"<1",29,14,22,19,6,29,51,41,44,34,92,95,"1",3,21,45,40,31,35,24,13,32,4,15,15,70,53,11,18,10,19,38,43,65,88,2,2,42,44,12,13,55,16,98,10,10,49,54,10,4,17,20,34,11,5,28,23,19,46,40,6,39,64,49,24,33,23,94,23,0,"2","1",10,37,14,31,6,66,35,30,38,62,87,27,90,100,44,53,60,30,7,2,11,100,9,52,31,20,27,34,14,37,59,71,35,"1",48,68,41,20,3,9,"4","1",17,2,41,"9",29,35,4,32,62,9,39,5,30,"1","1",4,13,7,81,"92",20
"2017-08-01",43,7,1,39,0,41,15,14,6,2,21,54,5,17,24,1,82,88,15,73,46,31,25,"1",5,26,95,2,8,18,71,54,79,31,48,90,30,10,54,52,50,81,1,31,41,0,35,21,21,18,45,21,23,22,15,14,26,26,18,88,65,29,64,13,28,41,43,53,14,9,12,14,76,65,6,16,"86",3,72,67,25,88,33,68,10,1,2,41,7,30,16,100,65,23,3,2,"0","0","1",4,3,13,"1","1",1,"<1",19,5,49,"<1",11,13,29,12,7,30,52,32,39,30,91,82,"2",5,23,41,39,31,33,22,12,28,2,16,14,67,50,19,10,7,23,45,40,47,79,3,2,59,49,6,15,57,17,88,17,9,43,55,5,4,24,14,27,11,1,32,7,10,41,43,9,37,68,32,22,27,20,79,26,0,"1","<1",11,38,19,25,8,68,32,25,35,55,100,31,83,84,36,48,46,19,3,2,16,89,18,52,31,23,21,39,10,35,65,73,37,"0",45,64,42,18,2,11,"1","1",12,2,36,"1",33,35,8,47,61,3,24,3,27,"1","2",9,18,9,78,"87",20
"2017-09-01",52,5,2,41,1,55,40,26,7,2,25,62,0,12,40,1,68,80,17,70,53,46,26,"4",14,30,87,2,8,20,64,50,70,27,40,82,25,8,65,50,52,72,2,40,95,0,60,26,24,23,46,21,25,28,15,15,22,36,20,77,67,36,61,17,25,43,63,54,11,10,13,40,81,63,7,16,"72",3,66,67,28,83,33,73,13,2,5,52,12,28,13,66,60,42,5,4,"1","1","3",11,8,14,"1","1",1,"<1",21,7,53,"<1",22,13,28,15,6,25,51,28,46,29,69,68,"4",8,20,38,48,48,71,41,43,46,4,15,13,60,50,16,13,6,34,49,37,57,76,4,3,66,51,17,9,52,28,77,15,14,44,60,4,2,41,18,23,13,1,41,12,15,52,48,7,38,56,25,29,33,22,69,21,0,"1","1",11,39,15,22,6,52,61,49,34,49,83,29,71,84,31,43,36,19,3,3,14,79,12,76,32,31,25,46,17,33,85,69,33,"1",34,65,37,38,5,25,"2","2",18,1,45,"3",42,42,3,31,60,9,30,4,28,"2","1",7,11,8,56,"75",13
"2017-10-01",54,8,2,46,0,63,41,34,6,2,32,65,0,15,37,1,66,77,12,65,53,50,25,"2",13,29,98,2,13,22,58,47,72,21,44,84,27,16,79,57,61,79,2,37,42,2,69,24,18,19,49,18,23,32,19,14,22,41,22,78,74,44,60,15,23,39,59,54,11,12,17,13,86,63,7,13,"71",2,73,62,25,82,33,69,11,1,4,61,9,24,15,77,62,53,2,2,"0","0","1",8,7,18,"1","1",1,"<1",21,7,63,"<1",17,21,30,12,7,24,48,27,47,31,75,67,"4",9,25,77,50,68,78,42,29,60,5,15,22,60,46,18,5,7,42,49,41,57,70,4,1,43,54,12,9,52,27,70,17,9,55,62,9,2,44,11,28,16,1,36,10,11,53,50,8,36,56,31,30,27,26,70,24,3,"1","1",12,44,10,18,5,63,87,66,31,49,74,31,70,68,29,44,33,17,0,4,17,73,10,42,33,34,24,48,10,35,84,62,33,"<1",39,66,37,42,2,20,"1","1",17,2,47,"1",44,51,4,46,57,2,26,4,28,"1","1",8,15,6,75,"74",25
"2017-11-01",56,10,1,46,1,79,35,30,3,4,25,59,0,11,37,3,53,65,16,63,51,44,24,"1",11,22,90,0,11,23,53,45,69,24,43,73,23,15,60,52,55,80,3,39,39,0,62,24,23,19,52,19,25,30,15,15,19,36,23,70,83,38,61,13,28,41,55,55,18,13,16,13,96,61,6,21,"65",2,65,67,30,78,34,67,12,1,13,55,39,20,13,72,65,53,2,2,"0","<1","<1",4,6,17,"<1","<1",1,"0",21,7,59,"<1",15,15,30,15,5,20,44,23,44,30,56,55,"3",18,19,80,55,70,73,37,26,58,6,9,20,62,44,18,9,7,43,47,34,67,71,5,2,42,47,11,13,47,32,64,19,13,49,65,6,1,43,13,29,17,1,37,6,10,59,48,10,31,55,28,27,17,22,63,24,0,"<1","<1",10,40,14,16,8,61,79,70,33,44,67,25,63,51,26,38,28,17,6,3,10,69,9,41,25,32,23,44,11,32,90,54,34,"0",46,62,29,42,2,15,"1","2",17,2,46,"1",52,56,6,40,51,2,23,3,20,"1","1",17,16,7,53,"67",14
"2017-12-01",51,8,2,47,1,57,24,21,2,2,28,53,0,9,45,1,60,74,14,78,46,37,25,"2",11,21,74,2,10,26,52,44,69,28,43,74,26,12,44,46,49,68,3,31,30,0,43,25,27,21,41,15,20,22,11,15,22,26,26,73,80,30,63,13,28,35,45,57,9,10,15,22,99,62,5,9,"60",4,80,78,40,82,26,71,10,1,4,51,28,23,14,64,54,43,4,2,"<1","<1","1",8,5,16,"<1","<1",1,"0",18,12,48,"<1",13,15,24,27,6,25,47,26,47,30,65,59,"2",12,20,72,48,66,53,36,31,50,9,12,16,58,38,12,7,6,36,43,35,43,71,4,1,40,38,16,13,48,25,62,14,11,43,57,7,2,31,18,36,19,4,30,5,8,44,35,7,30,52,39,22,21,24,68,24,0,"<1","<1",9,42,21,15,11,60,62,43,40,50,72,27,61,50,27,36,35,23,0,2,12,66,10,60,31,27,29,50,10,35,73,52,31,"<1",37,57,31,35,3,17,"<1","2",14,2,42,"1",43,50,4,31,49,3,37,1,19,"1","1",14,14,9,52,"65",25
"2018-01-01",51,13,1,46,0,48,27,23,0,2,16,60,0,10,33,3,86,68,16,74,52,41,28,"1",12,25,98,2,9,27,59,49,69,26,40,80,23,10,62,55,52,77,2,28,46,0,45,25,24,21,47,19,24,29,15,12,26,33,27,84,82,34,60,15,23,41,52,61,6,9,10,21,90,59,8,15,"77",2,52,66,28,80,35,69,10,2,2,49,19,29,18,87,56,36,4,2,"<1","0","<1",5,5,14,"1","<1",0,"<1",20,8,56,"<1",14,16,28,6,6,23,53,27,51,33,70,61,"4",6,25,81,49,41,38,34,11,42,5,18,15,75,52,16,13,6,39,45,36,58,87,4,2,52,44,13,9,57,23,70,14,12,52,64,8,1,40,16,25,13,2,35,6,10,40,44,6,37,61,34,28,13,26,67,26,0,"1","<1",11,46,35,23,12,66,48,31,39,48,91,32,75,57,28,38,44,21,3,2,8,76,9,51,31,27,20,53,17,37,62,68,31,"0",37,68,40,28,2,25,"<1","1",15,1,44,"1",44,54,7,30,67,5,31,2,30,"1","1",13,18,7,73,"82",18
"2018-02-01",58,15,1,49,1,77,35,35,4,2,22,64,0,13,47,3,83,78,15,75,53,52,27,"1",15,23,90,5,12,24,63,53,72,24,38,87,25,9,77,59,74,83,2,42,40,0,65,23,22,19,55,18,28,29,16,20,26,33,24,92,86,41,63,17,26,42,66,61,19,13,23,41,85,63,7,10,"81",4,44,65,25,82,30,71,13,1,5,51,31,30,17,92,67,54,2,2,"<1","0","<1",11,7,14,"1","<1",1,"0",20,7,61,"<1",14,17,32,8,7,20,44,29,56,39,78,68,"3",14,18,47,56,57,77,43,33,73,4,15,30,64,46,12,8,6,44,50,36,52,81,3,2,46,47,7,11,52,32,70,8,10,51,61,10,2,43,21,37,13,4,42,7,14,52,49,7,36,57,37,31,17,26,68,21,3,"1","<1",12,56,22,21,12,72,94,59,38,47,99,23,80,74,27,40,38,22,7,2,12,82,10,40,25,32,23,53,16,37,82,61,35,"0",33,73,29,47,1,25,"1","2",16,2,48,"2",58,66,5,36,60,3,28,3,28,"1","2",2,19,7,67,"87",12
"2018-03-01",59,9,1,49,0,76,42,36,11,1,22,61,0,16,38,3,92,85,15,85,51,45,30,"1",14,24,89,2,11,21,67,53,74,21,45,95,29,20,77,62,58,86,2,38,33,2,59,20,23,21,51,18,27,29,16,18,26,33,21,89,79,33,62,21,30,38,57,58,8,13,15,17,91,67,7,7,"81",1,51,62,25,77,30,70,11,2,2,55,26,26,16,86,71,50,1,2,"<1","<1","<1",4,7,14,"<1","<1",1,"0",20,7,59,"<1",13,20,32,17,5,23,45,30,52,36,83,83,"3",11,21,56,52,68,70,36,23,57,4,17,27,59,45,18,5,6,41,53,39,52,76,3,3,46,45,13,9,54,27,74,15,12,46,60,10,1,42,11,34,12,5,39,5,10,55,47,9,34,56,40,26,19,23,82,19,0,"<1","<1",10,42,17,19,9,78,90,60,34,43,96,30,79,93,33,43,42,24,9,3,13,89,9,47,28,33,20,55,19,36,88,61,32,"0",50,71,34,39,2,26,"<1","2",15,2,45,"2",45,51,6,29,57,4,28,2,28,"1","1",11,24,10,67,"89",21
"2018-04-01",61,7,2,49,1,86,48,33,7,2,23,62,0,9,49,1,88,78,20,81,52,49,30,"1",16,21,88,4,13,23,60,50,69,29,36,87,23,17,76,60,55,94,1,39,34,0,65,22,24,22,50,20,27,25,16,11,27,35,23,93,84,39,61,24,25,39,62,59,18,12,17,9,83,75,7,16,"80",2,55,67,27,85,32,78,14,1,7,62,34,31,16,94,80,57,3,2,"0","0","<1",5,8,14,"<1","<1",0,"0",20,7,62,"<1",16,20,31,14,4,22,50,27,57,38,84,81,"2",19,26,41,58,69,82,39,32,68,4,22,21,64,56,16,10,4,41,50,37,48,82,4,3,44,48,9,16,61,37,78,12,9,49,67,14,3,47,14,36,10,3,35,5,14,57,48,10,35,57,39,28,20,23,78,23,3,"<1","<1",9,42,13,16,6,76,100,74,38,43,98,32,77,82,30,45,40,19,9,3,18,93,12,40,26,39,19,66,11,43,92,66,33,"<1",38,68,36,40,2,29,"<1","2",16,1,47,"<1",51,59,5,33,63,2,30,3,32,"1","2",10,21,6,76,"97",18
"2018-05-01",52,4,1,49,2,61,28,22,7,3,21,57,4,8,28,4,98,89,10,80,47,40,28,"1",11,22,80,2,10,23,66,48,69,33,41,87,23,18,71,57,52,91,2,32,34,0,47,20,26,22,48,20,22,25,15,11,24,29,23,92,71,31,59,18,20,44,50,56,4,11,15,21,93,72,7,13,"76",4,49,71,29,90,35,71,16,1,6,58,24,25,14,91,75,38,2,2,"0","0","<1",8,5,13,"1","<1",1,"0",18,6,53,"<1",13,25,33,7,8,26,50,27,50,34,93,72,"4",15,24,48,54,44,54,30,33,49,2,15,18,64,53,12,9,4,38,49,36,45,88,3,3,42,44,13,15,60,28,80,8,8,47,64,9,1,45,16,28,12,1,35,5,10,46,42,10,35,56,37,24,45,21,77,24,0,"1","<1",10,36,9,14,4,82,60,45,36,40,88,37,73,88,31,44,40,21,9,2,17,90,9,43,27,32,24,45,12,44,75,68,33,"<1",42,63,34,30,2,25,"<1","1",12,2,40,"<1",46,50,8,44,60,2,28,1,35,"1","1",25,26,6,71,"93",28
"2018-06-01",44,2,0,41,2,48,27,19,2,1,24,55,0,12,22,1,100,100,14,93,44,32,27,"1",8,22,86,3,9,22,73,47,76,32,43,100,28,16,46,53,48,96,2,24,30,0,37,19,24,22,45,22,21,18,9,18,26,25,22,90,66,26,63,14,25,43,45,59,7,8,11,5,82,74,4,7,"79",3,42,75,31,93,35,77,13,1,5,43,14,27,13,85,77,30,4,2,"0","<1","<1",5,4,13,"<1","<1",1,"0",18,4,51,"<1",11,12,25,13,4,27,52,29,44,35,100,97,"1",4,25,47,42,35,48,24,16,35,2,15,15,70,52,14,8,4,23,43,38,60,100,3,1,38,41,18,15,60,22,90,15,11,47,48,9,1,19,20,32,11,4,31,5,13,42,42,8,37,60,38,24,36,23,91,20,0,"<1","<1",10,33,12,15,2,77,43,36,37,47,86,34,79,86,37,50,47,26,6,4,9,92,8,44,26,22,23,63,12,46,72,71,34,"0",38,63,40,26,3,22,"<1","1",11,1,36,"<1",33,41,6,39,65,2,22,2,31,"1","<1",3,25,6,85,"97",20
"2018-07-01",45,3,1,43,3,53,26,24,7,2,23,52,5,24,28,3,93,100,16,100,44,31,34,"1",9,23,92,2,8,25,76,51,80,32,44,100,24,18,48,50,49,100,1,21,31,0,32,23,25,23,42,22,19,15,11,14,27,22,25,95,73,24,64,14,27,46,40,61,4,6,10,5,82,76,4,0,"82",2,48,77,31,93,44,76,12,0,0,40,9,23,14,97,72,27,1,1,"0","0","<1",3,6,12,"1","1",1,"<1",18,5,47,"<1",12,11,24,17,7,23,48,34,50,34,88,97,"1",6,24,63,44,37,40,24,14,39,2,15,14,76,56,15,8,6,19,44,41,48,91,2,1,40,40,10,15,64,22,100,11,8,54,50,7,1,14,19,35,11,1,26,4,11,40,40,8,40,58,39,16,39,21,100,20,0,"1","1",10,33,14,15,3,79,41,32,36,44,98,39,79,96,37,48,54,27,0,2,13,95,12,48,25,22,20,43,12,47,64,73,34,"<1",48,64,36,30,1,18,"<1","1",12,1,35,"2",37,43,5,54,66,2,30,2,28,"1","1",2,27,10,85,"100",18
"2018-08-01",51,2,3,43,1,50,20,16,9,3,18,54,0,23,23,3,84,99,19,82,45,31,29,"1",9,23,87,2,8,24,63,50,75,27,48,91,25,12,46,57,50,96,3,28,37,0,35,21,31,23,46,22,21,19,13,14,25,25,24,93,71,24,65,16,28,40,46,60,9,7,9,9,85,66,4,9,"78",3,50,73,28,90,34,75,13,2,2,43,5,26,16,100,70,28,2,1,"<1","0","<1",7,4,14,"<1","1",0,"0",19,5,49,"<1",12,12,29,22,4,24,55,29,46,39,99,86,"3",7,24,50,47,40,36,27,18,37,2,11,15,71,53,14,11,8,23,42,38,59,84,3,1,42,42,8,16,62,22,94,12,9,45,58,7,1,25,20,34,10,3,31,5,13,38,43,8,40,57,33,21,26,20,83,20,0,"<1","<1",8,33,16,20,7,85,32,25,34,45,93,37,75,91,28,42,42,22,0,2,8,90,11,55,30,22,20,46,16,47,67,73,33,"0",40,66,36,23,1,22,"<1","<1",12,1,38,"1",47,49,8,41,67,3,31,2,28,"1","<1",17,20,6,73,"95",17
"2018-09-01",57,2,0,43,0,62,29,26,3,3,21,61,0,14,49,2,76,82,15,78,51,45,26,"1",13,24,85,2,12,22,53,45,65,24,37,74,25,15,78,53,56,80,2,32,37,0,64,20,25,22,45,19,23,26,12,14,21,34,22,90,77,38,59,15,27,43,66,60,13,9,14,13,86,63,6,9,"67",2,45,67,29,90,34,73,11,1,4,55,18,25,13,80,71,49,1,1,"0","0","<1",6,7,14,"1","<1",0,"0",19,6,58,"<1",17,20,26,12,7,23,55,22,45,36,95,82,"5",8,24,63,57,55,86,41,28,56,3,13,12,63,47,17,8,5,35,49,36,46,74,4,2,50,43,10,13,58,27,78,11,9,52,57,6,2,41,14,23,14,1,38,5,14,45,53,8,35,53,30,25,28,20,78,23,0,"1","<1",8,36,8,18,3,79,67,56,33,37,76,38,63,73,25,37,29,15,3,2,11,80,14,45,24,30,17,48,9,48,82,65,26,"0",45,64,31,41,3,23,"<1","1",15,1,43,"1",52,54,7,39,59,4,31,3,27,"1","1",8,20,10,67,"82",18
"2018-10-01",58,2,1,45,1,71,48,35,2,1,25,61,0,8,50,0,60,73,14,76,52,50,30,"2",12,23,84,0,13,23,50,41,64,23,37,84,25,11,64,57,65,77,2,37,34,0,65,18,22,21,56,23,24,28,16,15,18,35,23,87,82,44,59,18,21,36,58,59,19,13,19,30,100,68,5,22,"60",1,41,67,26,86,30,70,14,1,9,59,29,21,14,80,66,55,1,2,"0","<1","1",10,7,16,"1","2",0,"0",20,6,62,"<1",18,18,26,16,7,21,50,20,53,37,80,84,"<1",13,20,72,61,52,80,40,25,69,3,20,18,62,44,12,10,8,44,48,33,43,72,3,1,45,45,14,11,55,35,74,14,9,47,57,9,0,46,22,31,13,2,31,6,14,54,48,13,35,51,26,24,25,22,70,19,0,"1","1",9,43,12,18,6,72,94,70,33,33,83,32,59,76,26,36,25,16,9,6,13,75,7,42,28,34,17,58,10,42,90,65,30,"0",47,64,29,44,2,16,"<1","1",16,1,44,"1",59,61,10,33,56,3,47,3,21,"1","1",8,20,7,61,"79",20
"2018-11-01",56,2,1,42,1,73,33,30,2,2,24,55,4,10,39,2,67,62,12,73,48,41,28,"1",11,20,78,0,10,27,47,42,64,31,33,66,20,17,64,53,53,81,1,34,34,0,56,21,24,20,44,18,21,30,15,17,17,32,27,74,77,40,58,15,18,30,53,59,11,12,16,30,100,64,7,18,"56",2,49,67,30,75,29,68,12,1,4,56,9,23,13,82,56,51,2,2,"<1","0","<1",5,6,16,"1","1",0,"0",19,5,55,"<1",13,16,28,23,6,19,47,19,48,35,60,69,"2",13,22,82,58,46,59,35,30,56,2,11,22,57,44,11,3,6,45,48,35,35,78,3,4,43,42,9,11,52,28,66,15,7,47,53,8,1,40,20,34,12,1,32,5,14,50,41,12,32,49,29,29,18,22,63,24,0,"1","1",9,36,18,18,3,77,83,68,29,38,77,28,55,61,23,34,26,18,9,3,12,68,5,40,25,28,12,36,13,42,81,59,26,"0",29,59,28,38,3,21,"1","1",17,2,43,"1",46,54,14,37,50,1,35,2,22,"1","1",5,21,8,53,"71",18
"2018-12-01",46,2,1,49,1,50,32,23,9,3,27,47,4,8,37,5,64,74,15,82,43,33,23,"1",9,21,73,2,9,28,46,40,63,23,38,70,18,17,60,49,48,72,1,26,30,2,44,22,21,20,41,17,20,20,13,12,16,25,28,83,74,30,60,16,16,30,41,60,11,8,13,4,100,60,6,11,"55",2,63,78,43,81,31,72,11,2,4,49,16,22,11,71,58,40,2,1,"0","<1","<1",4,4,13,"<1","<1",0,"0",17,7,46,"<1",12,9,22,21,6,17,47,20,43,33,73,64,"1",8,17,63,48,46,50,29,16,51,3,11,14,57,41,8,6,5,35,40,32,38,75,2,2,35,35,9,9,47,27,64,17,6,48,51,9,2,33,20,28,12,1,28,5,9,40,31,9,33,50,30,21,22,24,71,20,0,"<1","<1",8,34,13,19,5,79,63,47,28,40,76,28,53,59,22,33,27,13,3,3,7,66,12,54,26,23,17,52,16,42,65,56,28,"<1",36,56,22,29,1,16,"<1","1",13,1,36,"1",46,58,10,28,49,1,30,4,20,"1","1",0,11,10,43,"72",10
"2019-01-01",53,2,1,48,0,59,20,17,2,1,14,59,4,7,35,3,84,79,14,78,54,39,29,"1",8,23,72,2,11,22,53,44,65,26,35,83,21,17,71,57,54,81,0,35,33,0,47,20,21,18,47,23,27,26,16,19,19,29,22,97,83,32,57,16,22,33,53,62,4,10,15,12,86,63,7,13,"66",3,49,67,28,82,32,71,13,1,6,52,9,24,14,100,73,41,5,2,"0","<1","<1",3,5,13,"1","<1",0,"0",20,6,57,"<1",12,17,28,15,5,19,56,19,45,36,75,64,"2",8,18,81,53,50,55,39,45,49,2,13,15,67,48,12,9,5,40,50,33,44,78,3,1,45,44,13,9,54,24,69,8,11,49,60,6,1,44,19,38,14,0,37,5,13,44,43,10,37,55,40,25,26,22,73,14,0,"1","<1",9,33,21,32,8,100,51,46,30,37,98,31,64,66,21,35,39,18,0,4,6,74,8,36,32,27,15,36,17,36,78,71,25,"<1",39,66,33,29,3,17,"<1","1",13,1,42,"1",51,56,9,47,63,3,28,2,29,"<1","1",5,23,8,57,"88",25
"2019-02-01",63,3,3,52,1,80,40,32,3,2,19,63,0,10,38,4,81,80,14,88,54,47,26,"1",12,19,95,0,13,19,54,48,66,29,40,84,22,9,71,53,62,85,2,41,35,0,62,21,26,21,47,17,28,27,15,11,18,34,19,100,84,39,60,15,24,34,63,62,13,14,16,52,88,69,8,14,"68",1,48,64,22,80,28,73,11,1,0,54,19,21,18,95,70,49,3,1,"<1","0","<1",11,6,14,"<1","<1",0,"1",19,5,58,"<1",18,15,30,12,6,20,54,18,51,37,83,62,"1",10,20,69,57,57,100,42,52,62,2,9,22,59,51,13,14,6,41,48,32,55,67,4,1,45,45,16,12,52,30,68,10,6,48,59,11,1,42,18,36,10,1,36,5,11,57,44,9,30,52,32,29,20,24,76,15,4,"<1","<1",8,34,8,27,6,91,85,66,32,32,98,31,65,65,26,36,31,22,11,3,10,82,7,30,26,31,19,53,17,38,96,64,29,"<1",49,68,26,42,2,22,"<1","1",17,1,45,"1",52,56,9,43,58,3,43,3,28,"1","1",10,22,6,62,"92",23
