"date","abnormalities","against.healthcare.reform","annual.earnings","annual.inflation.rate","annual.inflation","asset","athlete.black.swan","atlantic.city.coupons","balance.sheets","beautiful.places.to.visit","best.lunch.spots","bpa.safe","burger.places","businesses","calculating","california.housing","care.legislation","care.news","cars.under.10k","certificates.of.deposit","cheap.san","cheap.used","cheap","chicago.to.nashville","cost.of.rice","counsel","cpi","ct.unit","current.health.care.reform","dairy.cattle","determining","dynamics","education.foundation","educational.video","educations","equity.lines","estate.rentals","estimating","family.homes.for.sale","family.income","fashion.industry","fico.scores","filter.systems","financial.statement","food.crises","food.crisis","food.inflation","food.price.increases","food.price","food.prices","food.shortage","food.vs.fuel","ge.commercial.finance","global.food.shortage","global.food","government.run.programs","grants.and.scholarships","greenberg.dental","growth.rates","hc.bill","health.bill","health.care.cartoon","health.care.legislation","health.care.plan","health.care.reform.explained","health.care","health.insurance.bill","health.policy","health_care","high.food.prices","high.school.education","hospitality.jobs","hotel.coupons","housing.price","housing.prices","how.far.is.greenville","how.far.is.lexington","ignite.gas","illnesses","income.levels","income.statements","incomes","increase.in.food.prices","inflation.rate","insurance.reform","jobs.in.oregon","jobs.in.south.carolina","latin.america","law.program","lawrence.kansas","long.pixie","marketing","median.home.prices","median.price","medical.treatments","mi.to","money.for.college","money.make.me.come","natural.resource","new.health.plan","news.health.care","not.for.profit","nursing.education","oklahoma.city.jobs","opticians","orlando.discounts","parts.per.million","pizza.hut.pasta","places.downtown","price.index","qpublic","rate.of.inflation","rate.","real.estate.price","really.cheap","rear.delt","recycle.number","rent.craigslist","rent.to.own.sheds","rental.car.rates","rental.rates","rentals.in.north.carolina","resort.specials","rising.cost.of.food","rising.food.prices","sale.st","social.service.jobs","soils","texas.jobs","training.in","tx.employment","united.states.gdp","universal.health.care.bill","us.food.prices","us.health.care","us.health.reform","us.health","us.inflation.rate","us.inflation","utah.jobs","wall.street.journal.health.care","wedding.templates","wind.power.for.homes","world.food.prices","xpe","zillow."
"2004-01-01",93,17,56,43,89,100,0,30,54,0,0,0,2,94,86,82,20,19,0,71,48,86,85,0,33,89,82,26,0,61,85,91,100,80,65,65,90,99,20,74,80,45,95,64,0,6,17,0,33,48,6,0,22,0,27,100,53,9,57,0,1,0,0,15,0,26,2,86,24,80,98,74,52,91,69,0,0,0,83,79,22,81,0,70,6,53,55,91,95,75,0,97,23,47,50,6,64,0,59,13,6,65,90,65,100,65,86,0,7,81,0,47,71,72,66,6,15,1,0,56,66,59,85,0,0,13,56,68,62,79,44,84,0,64,24,5,51,57,87,65,18,36,0,0,71,0
"2004-02-01",79,0,100,100,98,100,0,49,80,0,0,0,2,100,100,76,22,23,0,48,52,71,84,0,0,91,100,13,0,100,72,94,88,71,69,51,85,96,14,74,64,54,100,90,70,10,16,0,43,47,9,0,32,0,27,0,38,9,100,24,1,28,24,16,0,28,2,98,28,26,77,63,49,60,73,0,0,0,95,72,19,83,0,86,6,40,51,93,94,83,0,100,36,50,35,7,38,0,92,28,10,77,75,44,98,64,49,6,7,100,6,66,70,59,58,9,14,1,0,82,69,38,42,0,0,14,48,100,60,76,47,62,17,0,27,5,56,71,100,60,36,22,0,30,39,0
"2004-03-01",98,0,71,75,42,97,0,50,89,0,0,0,3,94,89,88,28,21,0,52,59,77,83,16,0,92,96,11,0,56,85,100,99,60,100,71,89,94,12,88,69,46,89,93,0,5,21,0,32,38,9,0,0,0,28,0,45,0,38,0,1,36,12,14,0,27,4,95,24,0,90,70,48,66,52,0,0,0,99,74,70,80,0,80,9,36,41,96,76,80,0,94,29,52,71,10,43,0,88,33,7,90,88,44,94,57,85,0,7,88,0,92,74,70,63,7,0,1,0,75,78,29,67,0,0,17,45,89,64,80,39,58,0,81,28,0,56,40,79,42,23,34,0,79,82,0
"2004-04-01",100,0,58,81,85,91,0,28,57,0,10,0,2,91,96,88,24,22,17,53,66,80,82,24,31,91,83,0,0,62,91,94,83,86,92,62,95,91,13,74,77,43,100,95,0,4,64,0,32,53,10,0,73,0,9,0,49,9,62,0,1,54,6,15,0,28,2,88,18,51,100,74,45,95,70,9,12,32,83,66,37,71,0,100,7,62,60,99,74,88,10,99,31,51,75,8,63,0,100,20,8,59,82,29,49,48,78,8,6,97,0,79,74,100,72,14,14,1,0,77,70,67,30,0,14,15,100,98,62,75,42,96,0,61,19,5,68,85,87,62,0,27,0,59,62,0
"2004-05-01",83,0,62,29,38,90,0,17,52,0,0,0,0,87,76,64,10,19,0,51,71,80,89,0,0,92,79,0,0,41,72,85,77,69,46,53,84,94,17,56,74,52,59,77,0,14,22,66,37,57,3,0,48,0,20,0,26,12,56,0,1,25,16,12,0,25,4,75,16,46,85,78,58,81,80,0,0,0,84,55,46,55,0,70,5,71,76,99,72,81,9,88,36,61,43,8,51,0,70,18,3,75,77,48,68,65,74,0,12,86,0,85,91,68,77,8,13,1,21,83,63,37,42,0,0,14,62,73,66,78,42,100,0,93,19,4,56,42,60,58,0,26,27,27,87,0
"2004-06-01",80,15,32,30,49,94,0,18,58,0,9,0,0,89,79,100,12,14,0,71,83,81,96,11,0,98,89,8,0,63,75,85,90,89,49,100,95,81,25,60,62,53,69,67,0,0,15,0,31,28,3,0,58,0,24,0,31,8,27,0,1,0,8,16,0,27,6,81,25,0,82,100,75,78,93,9,0,0,62,78,42,58,0,64,8,55,75,57,70,94,0,94,53,62,44,11,68,0,42,28,9,90,82,58,75,35,88,5,8,91,0,45,83,62,73,5,0,2,0,100,81,76,70,0,0,15,61,58,71,81,53,43,0,0,17,0,45,29,63,63,0,37,0,28,80,0
"2004-07-01",47,0,28,16,30,92,0,72,40,14,0,0,6,88,76,78,15,17,0,98,79,85,100,11,0,100,87,8,0,62,68,80,82,64,84,60,100,89,13,59,68,65,71,80,0,4,15,0,25,18,5,0,70,0,25,0,32,8,38,0,1,0,6,16,0,25,3,72,13,0,76,90,63,100,68,9,0,0,63,54,51,50,0,65,6,80,68,43,65,78,10,92,42,62,52,12,64,27,46,29,5,63,100,23,78,41,70,5,8,76,0,48,73,89,54,11,14,1,0,84,100,68,58,0,0,15,72,84,68,78,67,55,0,39,17,5,54,51,42,56,0,46,0,0,60,0
"2004-08-01",60,0,29,28,37,98,0,16,45,0,0,9,2,89,65,82,16,18,0,70,77,100,93,20,0,100,85,7,0,48,76,83,82,70,70,86,96,86,23,54,70,52,95,71,0,7,0,0,22,15,5,0,100,46,15,0,39,8,41,0,1,23,10,18,0,25,3,86,35,0,90,75,48,86,83,0,0,55,74,41,21,100,0,50,6,65,75,47,100,84,0,89,100,61,47,11,52,0,39,24,8,96,89,21,100,41,75,5,5,86,5,45,69,77,64,10,0,2,0,66,87,58,53,100,0,13,70,78,67,77,43,43,15,35,20,4,52,60,63,68,0,43,0,0,46,0
"2004-09-01",72,0,28,60,26,90,0,47,89,12,0,0,3,89,94,72,20,27,0,71,60,78,84,10,0,88,85,7,0,56,78,88,92,78,62,44,73,99,14,57,78,64,74,95,0,6,0,0,20,21,3,0,52,0,14,0,27,7,56,0,1,0,10,16,0,29,2,90,7,0,94,74,41,73,57,0,0,0,86,100,41,86,0,81,7,59,43,74,81,78,0,90,40,71,100,11,66,0,65,25,8,100,91,23,73,35,74,5,7,79,0,56,65,69,100,5,23,2,0,53,75,49,33,0,0,12,74,98,60,81,50,72,0,33,27,6,61,50,49,65,0,26,24,24,98,0
"2004-10-01",100,0,53,54,27,94,0,24,100,25,0,0,3,85,97,54,24,24,0,70,50,63,83,0,26,91,89,14,10,68,100,90,83,92,79,42,60,97,19,93,80,51,87,83,57,8,27,61,41,48,5,0,35,0,26,80,31,7,58,0,1,57,10,23,0,30,2,100,38,0,88,59,36,76,55,0,0,0,79,79,51,99,0,77,12,47,61,92,66,75,8,87,41,54,46,13,46,0,68,21,9,79,81,36,65,48,72,5,4,85,0,70,80,59,75,10,0,1,0,39,49,44,34,0,0,11,26,99,54,73,37,76,14,34,23,4,69,65,64,44,15,31,0,25,88,0
"2004-11-01",82,0,63,35,37,89,0,49,85,0,0,0,0,85,91,59,9,23,0,62,57,60,81,0,0,93,89,15,0,56,84,83,79,95,86,57,61,82,8,77,100,70,70,100,59,16,0,0,39,47,9,0,82,0,30,83,28,8,66,0,1,0,15,18,0,28,3,88,31,44,85,68,39,66,67,8,0,28,95,81,39,89,0,88,8,46,61,92,76,78,0,84,50,63,53,15,66,0,64,15,7,59,86,37,96,62,64,0,7,86,0,77,80,70,58,5,24,2,0,43,49,29,57,0,0,12,49,88,50,69,41,100,0,0,26,4,56,60,97,41,0,28,0,52,75,0
"2004-12-01",59,0,41,50,48,81,0,22,44,11,8,0,2,73,75,68,10,21,0,83,49,61,79,9,0,82,79,13,0,27,68,74,66,86,60,29,54,85,9,51,47,35,67,61,52,9,37,0,34,33,3,0,24,0,17,0,19,17,39,0,1,21,7,13,0,22,1,77,14,0,63,41,37,60,84,7,9,0,80,58,37,76,0,81,5,34,64,79,72,78,8,78,34,45,41,8,46,0,51,10,5,65,68,29,89,51,56,0,4,81,0,67,74,73,50,4,11,1,0,52,45,26,59,0,0,12,65,91,48,58,35,76,0,32,18,0,53,82,80,39,53,21,22,0,70,0
"2005-01-01",64,0,50,33,36,91,0,26,85,0,7,0,1,85,77,73,18,17,0,82,63,78,91,0,42,94,89,14,8,55,77,79,85,85,77,65,77,91,16,71,81,58,79,81,0,5,11,0,29,28,3,0,93,0,62,65,45,9,24,0,1,37,14,13,0,25,3,73,15,0,88,64,46,81,72,0,16,21,94,70,29,70,0,85,9,62,80,80,73,85,7,85,54,56,69,10,60,0,78,17,6,73,93,36,77,39,79,4,8,77,0,67,66,75,68,4,19,2,0,49,66,61,62,0,0,13,74,74,66,80,73,69,0,28,15,0,48,63,85,69,12,51,20,40,85,0
"2005-02-01",88,0,56,29,46,96,0,41,45,11,0,0,1,81,96,60,10,21,0,84,59,71,85,0,22,91,86,18,0,70,95,82,97,77,87,62,77,100,16,79,89,81,49,97,48,6,35,0,28,40,4,0,75,0,34,68,35,6,81,0,1,19,19,13,0,27,1,82,26,0,87,65,47,78,73,0,0,0,100,57,30,77,0,89,5,52,60,100,78,92,7,94,54,58,44,11,50,0,72,22,9,79,75,55,47,41,84,0,9,97,4,74,100,68,81,8,10,1,0,58,76,88,62,83,0,14,56,74,59,78,50,95,0,44,17,3,54,89,92,50,13,24,0,42,79,0
"2005-03-01",82,0,65,49,32,95,0,52,66,0,6,0,1,81,87,80,19,22,0,65,67,71,84,11,56,94,93,13,0,59,76,80,91,73,60,30,74,94,18,72,52,86,51,82,0,12,20,0,36,36,7,0,96,0,16,0,35,11,39,0,1,16,9,13,0,27,3,78,19,0,88,57,41,78,81,0,0,38,96,86,61,83,0,87,6,60,75,80,67,80,6,86,41,66,78,12,60,0,71,23,7,73,79,23,62,90,68,3,6,86,7,76,73,71,76,0,13,2,0,44,68,66,68,0,0,17,55,74,57,81,40,77,0,25,20,6,59,51,90,43,0,62,0,37,96,0
"2005-04-01",84,0,50,17,44,90,0,46,68,10,7,0,3,84,93,100,17,19,0,81,57,68,80,0,22,87,92,17,0,38,90,80,75,76,52,43,77,92,26,73,63,82,67,89,0,11,17,0,36,52,10,0,73,73,12,66,30,6,63,0,1,19,12,12,0,27,3,76,12,35,97,60,48,86,76,0,0,22,85,71,37,80,0,89,6,66,72,100,82,85,0,91,55,76,42,11,65,0,70,17,6,77,77,36,74,43,51,0,9,81,12,71,68,93,54,8,20,2,16,61,67,72,46,0,0,17,56,92,63,79,53,86,12,0,24,3,58,37,74,64,0,38,20,20,79,18
"2005-05-01",72,0,51,15,46,87,0,64,54,9,0,0,4,77,82,87,15,14,0,83,63,69,84,11,58,92,82,8,0,44,80,73,77,62,54,23,75,81,16,63,56,71,93,81,41,12,15,0,41,45,3,0,71,0,40,0,21,8,44,0,1,17,14,11,0,24,2,67,25,16,86,79,50,100,97,6,0,0,78,63,36,70,0,65,3,70,79,88,63,84,6,83,55,76,37,11,65,0,62,15,7,71,73,53,72,64,48,3,8,70,0,66,64,94,59,3,17,2,0,64,73,64,56,0,0,14,44,92,67,77,49,37,10,25,12,3,39,66,62,62,0,61,0,27,100,0
"2005-06-01",58,0,28,36,34,92,0,36,53,0,0,0,4,82,80,58,12,22,0,87,70,70,87,0,40,92,83,19,0,42,70,75,75,54,68,56,87,79,19,53,40,100,73,75,44,4,15,0,28,20,4,0,61,0,25,0,31,22,56,0,1,0,4,12,0,26,4,62,20,16,75,69,60,98,96,0,0,0,71,36,27,58,0,72,5,84,77,59,60,84,6,86,66,87,39,14,65,0,49,27,5,67,64,55,53,46,47,4,8,77,7,48,47,76,73,7,27,2,15,71,82,65,91,0,0,16,60,72,71,76,47,44,11,0,16,3,57,39,50,73,11,40,0,38,74,0
"2005-07-01",69,0,28,31,54,91,0,24,43,9,6,0,1,81,67,78,20,17,0,80,75,71,88,7,0,96,76,8,0,49,68,69,68,62,53,45,83,77,30,62,30,75,72,66,0,7,0,0,22,28,4,0,73,0,25,60,34,19,51,0,1,0,15,13,0,24,3,59,20,16,61,63,74,83,100,0,8,40,69,51,20,64,50,60,6,69,66,45,63,95,0,81,79,100,69,17,65,0,34,16,7,81,67,46,87,58,49,4,8,65,0,52,64,79,58,9,13,4,0,78,83,95,65,0,9,16,56,73,72,79,64,24,0,26,12,0,43,24,61,49,0,42,19,19,58,0
"2005-08-01",73,0,35,29,38,93,0,23,59,0,12,6,2,79,68,68,19,28,0,78,73,86,91,0,0,95,81,25,0,43,70,73,67,59,50,70,72,86,21,50,68,89,56,76,40,6,0,0,33,25,4,0,94,0,31,0,22,5,43,0,1,16,9,16,0,24,4,65,24,15,78,64,55,93,91,6,7,0,67,54,30,49,0,54,6,87,72,56,77,88,12,80,61,83,32,15,58,0,29,29,8,80,72,48,89,29,41,0,9,65,3,47,60,86,46,7,25,3,28,71,63,45,49,0,0,17,66,59,71,78,53,43,0,25,15,3,46,50,55,56,10,47,0,18,69,0
"2005-09-01",68,0,61,44,47,82,0,36,51,0,5,0,2,82,91,60,16,19,9,68,58,65,77,13,0,88,85,12,0,50,76,73,74,59,73,46,56,85,12,64,50,69,55,92,0,11,18,0,28,33,3,0,98,0,12,0,27,19,40,0,1,0,11,15,0,25,3,69,27,21,75,77,29,82,74,5,0,0,70,72,33,80,0,80,5,49,66,75,81,95,6,83,68,79,45,14,49,0,59,22,7,68,77,29,67,24,62,12,6,79,0,52,78,70,57,0,31,2,13,40,49,49,42,0,0,12,57,85,57,71,44,42,9,22,12,0,55,68,72,65,0,38,0,24,71,0
"2005-10-01",71,0,50,33,33,81,0,15,48,7,8,0,0,79,91,58,11,21,0,63,46,62,72,6,16,98,98,21,0,55,83,70,77,83,73,44,50,86,15,74,64,64,51,81,35,14,8,37,35,33,6,0,75,27,40,0,31,4,56,0,1,0,7,15,0,26,2,86,21,26,87,49,36,78,86,0,6,65,69,72,46,74,0,72,8,53,71,84,71,90,0,80,41,59,45,13,31,0,62,18,5,70,61,37,72,27,44,0,7,79,6,63,61,67,40,3,14,3,0,57,58,29,21,0,7,12,53,75,51,72,48,65,9,31,20,2,56,55,77,55,0,32,0,15,56,7
"2005-11-01",89,9,49,47,39,79,0,10,33,0,5,0,0,75,85,56,17,17,9,57,48,49,73,6,0,85,83,9,0,58,66,70,72,100,60,46,49,83,14,59,73,61,55,83,0,11,0,0,31,40,7,0,67,0,41,0,32,11,57,0,1,0,11,18,0,26,3,78,19,13,75,46,29,77,75,5,0,17,78,55,39,74,0,77,9,41,51,91,65,76,0,82,56,76,57,13,45,0,62,16,6,70,71,33,69,23,71,6,9,71,3,90,64,50,45,6,22,2,12,44,52,37,27,0,0,12,51,91,49,67,29,74,18,86,28,13,62,81,80,47,18,29,15,23,73,7
"2005-12-01",58,8,49,45,42,77,0,19,42,0,5,0,1,69,71,57,12,12,0,66,46,57,70,18,0,74,83,4,0,51,66,66,71,79,42,35,51,64,13,61,53,28,68,64,0,7,16,0,41,28,4,0,63,0,35,0,19,7,43,0,1,27,12,14,0,22,3,58,25,13,59,58,37,68,64,5,0,16,71,45,35,77,0,75,4,43,46,73,52,75,5,68,47,68,27,11,45,0,37,20,5,57,50,17,84,29,37,3,8,61,3,51,59,55,45,7,14,3,0,40,41,49,33,0,0,13,44,54,48,56,22,51,9,41,15,5,48,58,68,42,0,22,0,30,63,0
"2006-01-01",63,0,61,25,57,88,0,30,60,26,5,0,3,80,80,57,12,21,0,78,56,75,81,8,42,87,89,13,5,63,72,73,77,61,58,56,74,86,23,64,53,45,65,71,30,4,14,0,39,42,6,0,75,0,27,0,31,6,40,0,1,24,12,16,0,26,3,70,14,0,76,50,41,81,75,0,5,14,71,59,28,72,0,73,5,57,73,72,66,85,4,78,32,66,33,14,57,0,52,19,7,60,80,58,88,53,60,5,9,70,3,55,83,79,39,4,19,3,0,56,66,67,66,0,0,15,46,78,62,77,42,53,8,18,18,2,51,62,74,56,0,35,0,13,56,0
"2006-02-01",86,0,52,30,74,90,0,26,34,0,5,0,4,76,93,59,17,22,8,71,59,61,77,5,29,85,89,21,0,54,80,74,73,61,84,44,73,93,23,70,73,55,55,91,63,7,11,0,41,30,5,0,88,0,18,0,31,14,49,0,1,38,8,15,0,26,2,79,27,12,80,55,39,72,70,4,11,15,85,76,45,85,0,81,8,60,57,80,79,77,5,79,49,54,38,17,47,0,72,15,8,66,85,51,65,40,100,5,7,70,7,63,76,80,56,5,13,4,0,44,51,52,45,0,7,17,59,83,53,76,43,51,0,0,17,2,52,57,63,45,0,29,20,27,73,9
"2006-03-01",69,0,53,36,65,91,0,15,53,0,8,0,2,75,84,60,22,16,0,93,60,61,77,10,25,89,78,15,0,69,73,80,71,78,85,32,63,79,20,70,59,52,62,82,0,7,16,0,31,32,5,0,47,0,30,0,24,12,56,0,1,22,9,14,0,25,4,78,13,21,87,56,47,77,74,0,0,0,80,75,37,73,0,81,5,44,66,80,67,100,4,78,61,70,39,15,43,0,48,17,8,66,71,35,72,47,65,0,9,74,2,69,86,81,44,7,11,4,0,60,70,47,43,0,0,17,52,77,55,74,52,57,7,33,20,4,49,76,65,60,0,32,18,0,55,8
"2006-04-01",64,7,48,38,100,87,0,24,49,6,6,0,3,76,89,58,28,24,7,97,58,58,75,13,0,80,85,14,0,75,67,76,67,68,56,52,80,80,17,69,61,36,68,87,0,9,14,0,36,48,5,0,95,23,22,81,27,6,57,0,2,0,11,14,0,25,7,70,27,11,79,65,44,98,78,0,0,0,76,65,51,64,0,80,8,55,64,77,77,86,6,80,50,60,58,16,44,0,61,13,7,58,63,31,78,55,63,0,13,65,6,70,93,80,57,5,6,4,0,31,52,64,65,0,0,17,55,75,54,70,55,67,11,26,24,5,52,63,87,49,0,31,19,19,64,11
"2006-05-01",57,0,41,26,26,84,0,19,55,12,6,0,2,74,76,60,18,15,7,59,66,62,79,7,38,86,83,19,0,41,67,69,66,59,59,51,66,71,15,58,54,57,71,71,55,8,23,0,36,47,5,0,43,0,35,0,27,11,51,0,1,0,12,13,0,24,5,62,13,10,81,63,35,73,85,0,0,13,79,73,28,66,0,66,8,58,78,82,60,91,4,74,45,83,44,16,42,11,59,20,6,59,72,52,71,35,39,3,12,72,5,43,71,85,50,6,11,7,10,46,59,73,43,47,6,17,38,52,58,75,53,59,0,33,17,2,45,50,69,50,0,32,0,12,70,0
"2006-06-01",65,0,32,56,55,85,0,25,43,0,4,0,2,71,73,56,16,20,7,69,68,62,82,8,27,84,81,9,0,27,61,65,69,48,59,56,71,72,18,38,62,47,60,70,0,7,17,0,25,15,4,0,95,0,26,0,27,9,58,0,1,0,6,13,0,23,3,55,14,0,62,46,59,68,89,4,0,27,62,45,31,46,0,64,5,57,78,49,66,85,4,74,46,54,18,19,40,0,43,26,5,65,66,35,62,56,50,4,8,70,10,48,55,79,53,4,18,6,0,66,59,71,59,0,6,18,43,61,62,73,56,34,7,18,12,0,43,53,67,61,8,64,25,0,48,0
"2006-07-01",50,0,16,20,22,78,0,52,50,6,6,0,3,76,62,67,11,17,14,100,70,62,83,10,13,72,72,26,0,16,55,66,60,29,43,33,83,72,21,53,38,68,73,64,0,5,20,0,35,17,4,0,53,0,15,0,26,20,39,10,1,0,7,11,0,23,2,55,9,11,56,71,62,88,70,4,0,0,62,28,16,46,0,50,5,43,79,34,58,83,0,69,35,64,26,19,59,12,24,22,3,55,71,48,91,50,33,2,12,54,4,33,65,94,57,12,18,6,10,67,68,75,66,0,6,19,59,49,63,77,56,24,7,17,12,0,39,42,51,55,0,52,12,12,60,6
"2006-08-01",67,0,32,25,24,82,0,44,38,0,4,0,2,75,68,62,11,15,19,80,66,76,80,7,24,80,75,18,0,37,57,70,68,63,45,46,67,69,18,51,44,45,49,64,26,4,9,0,29,19,2,0,60,0,28,36,27,8,21,0,1,21,4,12,8,24,2,57,12,10,69,57,46,57,83,4,0,36,54,50,18,51,0,54,3,62,66,35,62,83,6,73,44,60,28,19,62,0,44,18,7,57,66,37,75,44,33,2,9,60,4,53,68,71,60,0,16,7,9,62,63,33,60,0,6,18,60,42,62,75,54,26,0,31,15,2,41,44,40,63,0,39,34,0,66,5
"2006-09-01",52,0,26,34,20,78,0,43,71,11,4,0,1,72,84,42,11,18,13,58,51,60,74,9,0,85,79,16,0,47,66,66,72,57,63,36,55,77,19,58,60,43,54,69,0,2,9,0,33,29,3,0,56,0,35,0,25,12,36,9,1,0,8,13,0,24,3,70,24,0,68,55,37,69,77,7,0,12,69,30,32,79,0,70,5,62,52,63,47,79,0,73,27,47,41,17,45,0,46,20,7,60,76,33,63,24,59,2,8,58,8,60,46,72,56,9,8,5,0,55,50,57,44,0,5,16,46,58,58,66,36,53,6,31,20,2,42,56,62,52,7,30,11,17,49,5
"2006-10-01",56,0,34,37,23,83,0,30,75,0,0,0,4,71,84,52,14,19,6,65,50,52,72,4,22,81,79,16,0,38,73,72,73,58,58,32,53,73,12,64,70,44,62,78,0,9,17,25,34,25,5,0,48,0,26,0,21,11,54,0,1,10,15,15,0,26,2,68,13,13,63,59,30,82,91,0,0,0,59,76,52,61,0,71,8,63,77,70,63,82,7,77,61,68,36,17,40,0,61,23,5,76,84,29,69,42,47,6,11,65,15,50,56,62,60,4,10,6,8,46,55,37,45,0,0,15,33,86,56,68,40,37,0,14,19,2,53,55,69,50,12,28,31,21,49,5
"2006-11-01",67,0,34,45,59,77,0,17,49,5,7,0,3,65,77,49,14,22,6,52,44,49,71,10,43,77,76,13,0,44,61,68,66,66,65,33,52,62,21,60,60,39,59,73,47,7,11,0,34,34,4,0,29,0,32,0,25,15,55,0,1,0,12,15,0,26,2,63,17,0,66,64,36,57,63,3,0,22,75,54,55,68,0,76,4,51,48,69,56,79,3,72,51,60,49,15,44,29,52,15,6,62,64,33,64,23,50,3,9,59,2,53,59,63,32,8,27,5,0,61,50,29,42,0,0,15,50,74,46,61,44,43,0,14,19,2,51,56,62,43,0,23,0,21,55,5
"2006-12-01",56,0,57,37,67,68,0,13,48,0,7,0,2,63,63,39,7,14,6,54,44,51,70,10,22,71,63,30,0,24,56,57,55,65,50,23,50,58,15,47,45,26,53,66,24,5,9,0,33,24,4,40,41,19,35,0,16,14,44,8,1,0,8,10,0,21,2,51,10,0,50,39,33,39,54,0,0,11,68,58,26,57,0,61,5,37,43,64,49,70,5,61,35,41,55,14,36,10,36,21,5,39,52,30,52,37,37,6,7,53,12,40,62,49,52,8,15,4,0,40,50,43,31,0,5,14,41,73,43,55,40,35,6,14,14,3,38,49,60,40,0,31,0,10,47,5
"2007-01-01",63,0,51,55,70,82,0,18,39,5,5,0,4,75,73,46,12,19,16,71,53,65,79,4,29,81,77,22,0,39,63,68,71,71,75,43,74,76,24,67,67,55,50,66,0,8,7,23,31,24,5,0,52,0,20,30,29,16,35,7,1,8,9,15,0,26,3,60,13,0,66,54,42,60,51,3,4,29,69,67,31,67,0,66,9,47,58,59,68,80,3,75,48,49,27,17,55,0,48,19,7,61,83,33,79,55,43,4,10,63,2,64,73,69,54,4,15,6,0,44,58,78,58,0,0,17,48,64,60,80,55,36,5,25,18,3,45,77,54,60,5,35,18,18,60,10
"2007-02-01",70,0,48,48,38,90,0,34,46,5,3,0,2,73,87,43,8,21,5,56,55,62,82,12,20,77,76,11,0,48,69,71,71,62,60,39,65,74,20,61,57,40,39,80,0,6,5,0,33,27,5,37,38,0,29,62,24,16,42,8,1,0,8,14,0,25,3,68,25,25,65,54,36,51,54,3,12,21,62,59,29,58,0,74,6,47,65,63,68,76,3,78,61,54,45,16,41,0,44,20,7,54,79,44,70,56,71,8,10,58,7,51,85,65,63,7,12,7,0,55,57,64,48,0,0,18,49,66,54,76,42,38,11,0,18,2,46,28,59,43,6,39,38,10,52,4
"2007-03-01",56,0,43,50,47,84,0,31,47,4,6,3,2,74,78,51,18,21,5,44,57,56,81,7,37,79,70,32,0,42,68,68,70,47,54,37,67,78,19,65,51,62,73,74,0,11,9,22,39,40,4,0,47,0,35,28,23,24,45,0,1,8,9,12,0,25,2,64,16,7,68,51,40,73,71,3,4,9,67,72,39,58,23,74,6,61,66,68,64,81,3,73,34,51,26,18,45,16,53,20,6,63,67,35,72,48,48,3,11,50,10,49,61,60,50,8,17,9,7,50,68,79,48,0,4,20,51,73,58,72,48,36,10,42,20,4,51,50,55,46,15,39,9,9,57,8
"2007-04-01",63,0,41,56,42,84,0,28,37,13,3,0,2,71,79,50,17,22,0,53,64,58,77,9,47,79,68,16,4,43,65,68,63,62,60,47,70,73,21,55,62,42,55,80,0,9,19,0,40,40,5,34,38,0,38,0,26,22,54,7,1,8,8,13,0,24,2,60,19,7,65,43,34,63,68,0,7,9,70,71,36,67,0,73,6,55,55,62,58,81,5,76,41,56,22,18,49,0,38,17,7,68,65,30,78,70,60,5,10,54,9,70,66,66,55,5,29,10,7,60,55,70,38,0,0,20,59,81,57,76,49,46,0,24,19,1,50,100,83,43,5,40,17,26,44,8
"2007-05-01",68,0,45,42,40,83,0,28,44,8,7,0,2,70,73,58,8,23,9,47,62,69,82,14,17,80,70,35,0,43,61,67,58,45,54,30,76,66,15,60,46,48,72,67,18,6,33,30,46,54,3,31,40,0,36,26,34,13,34,0,1,11,5,13,0,24,4,53,17,21,67,49,41,74,57,4,3,17,70,57,29,55,22,71,4,52,74,65,57,81,10,74,37,67,57,21,45,8,46,17,7,56,72,42,74,69,35,5,15,58,8,49,67,64,62,8,13,11,0,63,58,68,66,0,4,22,47,78,59,73,50,40,9,55,18,0,39,44,68,48,9,58,32,40,64,0
"2007-06-01",54,0,40,28,34,83,0,36,33,17,7,6,2,72,64,44,15,17,10,43,75,62,88,14,0,78,70,21,0,38,55,65,54,38,48,29,77,64,18,54,50,47,78,59,20,4,14,21,35,29,3,33,67,0,25,0,26,11,29,0,1,8,10,14,0,25,3,59,18,7,61,44,59,73,66,3,3,18,58,44,26,50,0,53,6,74,56,45,65,77,10,73,37,47,33,23,51,0,33,21,8,57,63,46,71,54,40,5,15,51,8,50,61,60,65,6,14,12,17,81,76,68,68,0,4,21,52,58,65,77,47,28,0,36,20,3,51,56,60,74,10,59,21,17,47,0
"2007-07-01",63,0,23,27,35,87,0,39,36,12,8,3,3,75,63,50,12,25,14,53,82,68,90,19,9,76,62,20,0,37,54,66,61,47,41,30,90,61,22,52,50,42,61,59,19,5,16,0,31,29,3,31,61,0,29,0,26,16,40,0,1,7,10,15,0,26,2,57,19,7,50,80,65,62,67,5,7,9,59,47,29,40,0,49,6,62,77,39,65,77,10,70,37,57,41,24,63,0,33,16,8,58,60,42,85,55,39,3,15,51,4,42,67,78,75,12,27,15,10,69,76,100,53,0,12,24,65,55,68,81,59,25,12,11,22,5,50,32,46,53,14,56,0,8,49,7
"2007-08-01",54,0,27,21,37,87,0,45,33,8,8,9,4,72,59,62,8,23,13,55,72,79,87,9,25,85,65,25,0,29,54,68,59,45,47,31,70,69,21,53,49,44,60,63,0,3,11,19,32,22,2,0,47,0,27,0,27,19,35,0,1,7,5,14,0,26,4,51,13,7,68,67,52,66,69,6,0,8,54,40,29,52,0,40,6,65,79,41,56,86,11,73,37,68,49,23,61,7,43,22,6,67,62,51,91,50,44,8,11,48,13,34,74,65,76,10,11,13,6,64,59,74,60,0,0,21,58,42,60,77,54,29,0,21,16,3,44,29,40,64,14,56,12,8,52,3
"2007-09-01",67,0,33,49,42,80,0,30,56,8,7,7,4,73,85,42,7,20,13,49,56,64,79,9,49,83,74,14,3,38,61,67,66,64,46,40,52,68,18,63,69,41,48,75,18,9,13,0,31,32,3,0,50,14,49,0,26,22,43,0,1,14,9,19,0,27,3,68,23,7,70,63,42,65,62,4,0,8,67,53,42,50,0,68,7,74,68,60,67,77,8,74,47,73,21,22,59,0,52,17,10,55,72,40,72,35,49,9,12,57,11,59,71,64,59,7,22,11,6,49,52,54,27,0,8,19,53,67,54,76,57,45,4,11,25,3,49,57,70,51,9,24,19,12,57,7
"2007-10-01",64,0,57,55,66,91,0,40,50,3,6,14,3,78,84,49,9,21,4,39,52,57,75,8,29,84,75,14,0,48,71,70,65,63,59,34,53,67,18,65,74,39,56,78,16,7,26,34,39,37,4,27,73,0,31,0,24,13,37,16,2,13,8,19,0,27,7,69,21,12,61,58,40,56,66,2,3,36,67,59,46,61,36,67,7,62,58,69,67,79,8,75,32,66,41,19,44,13,54,24,10,64,73,41,65,37,60,6,12,59,12,58,76,49,63,12,13,11,11,34,50,44,32,27,5,18,57,69,53,74,48,42,8,9,20,3,55,64,66,59,4,37,7,14,56,6
"2007-11-01",69,0,50,40,40,83,0,36,44,10,7,7,4,72,75,40,16,21,8,44,49,59,75,11,44,78,71,28,0,44,62,65,61,72,51,34,44,65,14,75,62,47,42,75,16,14,21,34,42,41,10,27,57,0,50,23,21,25,46,0,1,10,12,18,0,27,2,69,19,21,60,55,35,67,66,2,6,22,66,58,47,64,0,73,6,54,62,68,63,70,4,73,30,46,47,19,54,7,49,16,8,67,64,28,72,39,51,4,16,62,14,59,64,55,59,8,23,10,22,30,50,47,29,0,3,18,38,66,51,71,46,51,4,48,32,2,54,40,81,44,12,32,7,7,53,3
"2007-12-01",44,0,52,28,39,72,0,21,26,0,15,7,3,60,64,36,6,19,4,35,50,58,74,9,30,64,66,17,0,28,60,55,48,53,41,32,45,60,14,55,48,28,55,55,0,8,27,0,39,37,5,27,51,13,33,23,23,8,37,0,1,7,4,15,0,23,4,49,14,12,46,52,30,75,74,5,0,46,53,43,32,54,0,60,3,50,57,61,59,73,4,58,35,42,25,17,48,20,42,16,5,53,55,34,60,46,50,8,11,52,11,58,42,48,65,6,24,9,6,39,48,42,52,0,5,17,46,53,48,62,43,41,6,45,21,3,44,58,61,48,0,24,11,14,45,3
"2008-01-01",63,4,40,56,50,86,0,35,42,6,6,13,6,73,72,47,15,24,7,64,58,77,83,8,46,77,83,22,0,40,63,67,60,59,57,37,70,66,21,74,47,92,56,64,14,7,31,31,48,36,8,0,41,11,30,0,35,15,41,10,1,9,9,18,0,27,4,60,12,14,63,77,39,68,74,0,5,27,60,80,32,62,17,77,4,66,84,59,70,68,4,71,53,70,46,21,60,12,49,20,7,61,76,53,88,37,39,8,13,57,12,56,58,54,53,11,33,11,20,37,60,69,60,0,6,24,56,61,62,83,61,38,7,18,21,2,50,71,94,57,19,40,19,22,39,3
"2008-02-01",57,0,39,29,35,85,0,40,56,3,3,17,4,75,82,45,18,20,0,43,59,69,81,6,41,79,81,13,3,53,67,67,62,66,53,47,60,72,22,77,62,55,49,73,0,8,21,16,52,41,7,25,60,12,50,21,34,16,45,0,1,9,11,21,0,28,3,73,17,11,63,73,51,75,76,4,3,0,69,65,36,59,0,79,7,59,69,65,67,75,8,73,60,86,38,22,44,12,50,21,8,60,75,53,74,49,67,7,12,63,15,61,66,62,66,9,17,12,13,50,58,50,54,26,11,24,39,64,58,81,48,53,4,23,25,3,50,50,76,51,8,36,29,16,65,9
"2008-03-01",60,0,38,47,44,84,0,18,47,13,4,10,5,71,78,49,15,27,18,68,70,68,83,11,20,77,79,30,0,42,63,75,66,62,59,45,69,67,22,69,45,53,53,68,15,14,40,47,46,54,10,24,25,11,34,20,29,23,53,10,1,6,9,17,0,26,3,64,14,14,62,58,45,87,87,2,3,27,68,69,44,56,0,83,5,73,71,62,54,71,10,72,50,64,48,23,55,72,49,21,9,65,64,37,63,66,62,8,17,62,13,66,68,62,74,8,24,13,15,42,61,60,46,25,12,30,53,62,59,85,47,39,5,70,23,2,51,52,82,63,11,39,38,35,51,6
"2008-04-01",62,3,65,43,60,87,0,16,65,6,8,100,5,74,82,41,17,24,14,43,62,68,79,6,53,79,82,31,0,57,68,72,62,64,60,35,64,67,20,72,77,41,63,84,100,100,75,100,76,99,100,60,44,100,100,30,34,17,49,0,1,17,13,18,0,27,5,71,21,88,65,78,51,76,81,3,3,67,67,65,45,68,100,81,7,72,81,66,70,84,5,76,48,61,50,23,58,100,55,21,10,60,68,42,64,39,61,100,15,67,13,68,75,61,67,8,100,14,10,44,60,50,36,98,58,27,50,69,64,83,50,52,7,95,26,1,61,73,90,55,11,46,62,100,66,3
"2008-05-01",44,0,34,16,27,75,0,24,50,9,12,62,5,67,67,47,17,21,11,45,71,71,85,14,53,78,72,21,3,35,60,65,60,56,53,30,69,61,22,62,50,48,68,61,50,89,60,78,70,100,45,72,58,34,57,0,29,17,33,5,1,12,5,14,0,24,3,57,16,100,66,54,57,70,85,2,0,54,60,44,32,60,51,69,4,75,78,58,59,70,2,69,51,59,39,26,58,89,41,18,5,65,70,56,71,55,48,64,15,56,14,51,68,53,71,4,69,15,7,40,56,58,61,74,100,28,51,59,64,78,61,43,11,100,18,3,47,38,64,61,4,50,100,79,50,4
"2008-06-01",52,0,40,33,45,80,0,73,30,10,8,31,4,70,64,39,11,22,19,45,84,73,90,9,63,77,78,23,0,28,50,64,54,29,37,36,72,58,23,57,42,39,65,64,77,58,44,66,59,71,24,90,28,30,44,21,26,20,29,0,1,0,7,14,0,23,2,58,11,57,53,74,68,63,65,8,5,50,52,50,25,50,18,63,4,80,75,39,60,66,7,66,38,59,23,29,46,63,31,14,8,57,60,52,71,70,41,56,19,60,16,48,63,58,74,12,46,17,16,52,68,78,93,26,42,28,50,58,72,79,64,24,6,83,17,1,46,38,79,62,4,46,40,67,53,7
"2008-07-01",43,4,38,31,23,83,0,59,45,9,13,38,5,66,59,44,12,18,0,66,81,78,85,10,40,78,81,24,0,32,50,63,52,33,39,29,75,55,19,51,41,46,70,61,44,37,42,47,50,41,10,25,48,17,47,0,32,24,25,5,1,6,4,15,0,24,2,54,16,25,53,77,67,61,63,6,15,41,53,50,23,39,0,60,3,67,78,34,55,71,11,66,29,49,16,29,62,30,23,17,7,58,67,43,74,68,34,38,20,63,17,44,63,60,82,10,52,18,13,57,68,74,100,0,22,29,49,47,73,83,69,26,4,97,19,2,45,58,65,74,0,52,38,22,53,9
"2008-08-01",47,0,31,33,39,72,0,53,45,13,9,23,5,62,53,36,6,21,11,44,71,78,84,10,40,74,71,34,0,31,47,62,47,36,43,40,59,54,18,51,41,49,49,57,29,25,36,16,40,29,6,0,45,11,21,0,36,22,27,0,1,12,7,14,0,22,2,51,17,11,58,61,57,60,55,2,3,68,44,54,24,43,0,54,3,68,74,34,52,71,11,65,27,53,17,29,61,24,34,15,6,53,60,37,67,41,39,39,19,53,19,38,46,47,84,8,35,18,5,44,59,57,55,25,8,30,54,45,71,82,72,27,0,44,15,1,40,53,74,68,7,42,28,29,45,6
"2008-09-01",63,0,22,26,30,84,0,32,53,18,8,35,3,67,73,36,13,25,13,55,55,65,77,13,25,80,77,20,0,30,59,70,61,61,55,23,52,64,19,67,49,39,55,77,27,35,39,29,45,48,12,23,61,21,49,29,62,29,36,0,1,14,9,21,0,26,3,75,15,15,61,78,37,74,67,8,2,25,57,60,38,54,32,75,3,75,63,54,60,71,9,69,42,51,40,27,56,22,45,16,10,57,71,51,72,41,55,72,15,67,14,54,58,47,69,6,38,17,14,37,64,50,31,70,17,25,62,56,73,79,61,54,3,57,25,3,47,62,85,66,4,51,18,45,53,3
"2008-10-01",60,3,57,38,35,88,0,45,56,13,9,20,8,71,79,30,11,22,9,61,59,59,79,11,40,78,91,31,0,47,60,69,65,63,53,22,48,68,19,72,57,48,59,80,49,50,29,27,51,54,22,31,40,29,47,17,59,17,40,0,1,12,5,40,0,30,5,80,12,23,57,71,44,69,77,2,7,69,64,58,46,55,43,84,4,80,75,64,62,65,10,71,39,46,57,26,64,31,50,19,10,59,71,60,73,50,50,49,17,77,12,68,60,50,71,11,33,16,11,36,52,41,40,42,16,22,54,57,69,77,64,64,11,63,32,1,53,52,87,64,13,52,29,46,57,5
"2008-11-01",61,0,45,30,21,76,0,19,51,6,4,22,3,64,64,28,13,21,10,35,54,65,81,11,44,72,70,19,0,40,61,63,54,67,43,20,45,57,20,79,64,27,56,74,55,41,34,0,61,54,18,23,30,16,59,19,59,14,44,0,1,11,10,25,0,26,4,77,21,38,55,76,40,67,60,3,5,19,63,65,35,44,32,66,3,65,58,58,56,60,12,66,39,45,52,25,57,17,38,14,8,58,68,54,59,33,49,29,12,62,12,46,47,45,59,10,31,14,14,44,58,34,49,47,36,23,50,54,67,75,53,45,5,54,29,3,56,39,76,77,0,39,15,24,41,9
"2008-12-01",51,3,41,25,27,73,0,20,37,6,7,9,3,55,58,35,7,20,3,40,56,70,86,7,49,65,65,18,2,46,52,59,46,51,40,18,45,52,19,61,40,27,49,61,53,27,17,14,49,48,16,55,18,21,47,18,59,19,32,5,1,11,5,15,0,22,3,55,13,27,46,65,51,50,62,4,7,37,58,42,26,37,62,54,4,62,64,51,53,65,15,57,46,39,34,23,59,27,35,17,8,44,53,52,63,54,42,22,14,58,10,46,56,46,83,10,23,14,0,43,61,44,54,23,15,21,47,49,65,68,54,49,3,44,20,1,41,30,51,75,7,35,23,17,37,4
"2009-01-01",47,0,36,33,41,75,0,28,37,8,7,9,4,67,64,35,13,28,22,45,69,83,89,5,58,77,79,28,2,40,55,70,61,46,40,25,69,63,29,77,56,41,61,69,19,25,30,0,47,41,8,21,37,10,52,36,97,25,32,0,1,5,7,16,0,24,5,63,19,17,61,97,56,65,68,9,0,59,58,53,32,42,0,51,4,92,94,53,70,62,10,67,28,40,28,27,76,36,44,22,9,58,80,63,70,61,46,23,16,56,15,42,54,49,78,10,43,21,11,57,69,60,85,0,8,32,53,50,89,93,82,42,3,34,18,3,48,43,51,92,13,56,38,39,45,7
"2009-02-01",55,3,44,25,27,86,0,33,62,17,10,15,8,68,83,33,8,26,13,45,68,76,86,14,30,80,84,27,0,45,67,72,65,71,47,19,64,61,30,82,48,48,63,82,20,33,32,14,57,45,14,33,25,10,40,0,87,8,49,7,2,11,7,19,4,27,9,69,16,15,64,79,62,70,82,2,0,6,60,64,53,43,31,67,5,72,79,63,72,68,6,70,51,56,45,28,67,22,37,19,10,57,76,79,71,72,59,21,17,63,14,49,64,53,75,11,28,22,9,76,76,53,82,23,17,32,45,58,79,94,70,60,7,28,25,5,55,36,69,72,10,63,46,32,41,5
"2009-03-01",58,3,50,27,36,87,0,38,59,13,7,16,7,67,74,39,13,25,12,44,76,77,90,9,61,76,77,40,0,41,63,71,60,51,46,18,70,62,31,70,48,45,64,72,42,32,20,38,59,50,16,100,24,28,62,25,73,24,44,4,1,10,7,20,0,26,4,69,26,11,66,64,81,63,66,5,13,56,68,60,39,47,14,62,6,84,80,59,82,65,11,69,32,55,37,31,78,25,44,18,9,54,77,65,72,92,48,26,19,57,15,48,60,57,83,10,27,22,8,60,79,55,68,20,14,35,49,64,81,93,68,53,7,14,27,9,58,30,67,84,12,60,33,21,41,2
"2009-04-01",64,3,46,37,33,81,0,36,51,8,6,12,7,66,77,39,19,27,15,39,69,76,84,13,46,77,75,27,0,55,60,70,63,64,41,20,63,62,29,68,47,37,66,78,25,32,10,13,53,46,10,0,23,19,41,26,67,23,40,0,1,12,10,19,0,26,4,73,30,14,64,77,62,56,60,8,2,35,67,46,49,39,0,61,7,73,75,66,67,65,9,71,30,37,25,29,77,5,43,20,10,58,64,76,66,64,53,21,19,51,19,49,56,49,70,10,22,23,8,68,73,59,70,0,16,39,57,73,83,87,65,47,9,30,26,4,55,58,62,76,3,74,16,40,51,7
"2009-05-01",56,0,32,28,31,74,0,37,41,13,17,18,6,60,60,37,15,24,30,26,76,78,86,13,45,70,67,33,0,41,52,65,51,42,48,16,65,53,25,59,58,34,65,62,37,25,16,26,52,45,7,20,26,29,47,0,79,14,29,4,1,10,10,18,4,24,4,56,22,7,58,78,80,45,54,8,4,28,56,37,30,35,0,52,7,72,75,51,58,63,14,66,27,38,27,32,79,20,38,10,9,53,61,72,63,79,35,62,17,44,13,43,55,51,84,8,42,24,10,70,79,64,70,0,5,38,62,57,85,88,77,31,12,44,20,5,49,44,51,78,6,66,31,21,44,9
"2009-06-01",52,3,28,30,20,81,0,60,35,11,13,15,10,61,56,32,25,31,16,25,89,83,95,12,23,74,67,28,0,27,49,64,56,42,39,14,80,49,33,51,34,34,79,62,13,12,13,0,44,37,6,21,18,10,30,18,96,14,30,4,2,10,16,26,12,29,6,61,23,14,58,84,89,45,44,7,7,35,50,36,32,26,0,43,12,100,95,37,66,64,10,68,18,29,30,36,78,26,21,22,15,58,71,77,89,83,49,28,19,46,16,35,48,46,76,17,32,25,9,83,95,89,87,22,4,39,54,47,96,92,84,25,9,19,30,9,47,32,47,100,26,91,30,17,47,5
"2009-07-01",42,33,20,26,21,76,18,93,26,27,9,21,9,61,53,35,58,37,12,30,91,87,97,12,23,70,66,33,26,27,44,62,50,33,30,15,82,52,31,58,30,27,78,54,12,15,12,0,46,33,7,21,19,10,34,61,86,23,32,32,11,12,52,69,15,40,16,61,37,9,52,94,100,39,47,5,9,46,46,44,27,25,0,43,22,84,94,29,63,65,18,64,25,30,22,37,90,20,21,37,22,53,68,78,78,100,35,12,22,41,13,36,40,53,92,9,22,27,6,78,96,88,90,0,8,40,70,41,96,94,88,22,45,7,47,30,61,35,43,91,44,87,13,27,47,11
"2009-08-01",53,60,24,13,15,74,44,73,26,5,12,18,8,62,50,27,73,50,3,31,87,93,94,12,17,73,65,26,25,32,45,60,51,34,35,12,75,47,33,56,34,27,78,56,0,10,10,0,49,29,9,21,19,19,28,86,92,13,30,46,23,41,78,100,30,55,19,66,43,18,55,70,78,42,40,7,6,45,44,27,22,30,14,40,45,83,81,34,72,66,17,63,18,32,30,38,100,10,23,53,36,56,69,74,84,61,33,21,23,40,9,31,36,46,80,8,51,25,15,65,93,61,82,0,3,41,63,37,98,90,84,22,40,26,65,47,73,23,40,99,53,79,29,5,47,10
"2009-09-01",61,34,39,27,24,77,67,41,51,13,15,19,8,65,76,32,34,45,23,20,73,77,84,9,38,75,72,34,22,47,63,68,60,56,45,14,55,60,26,61,58,20,91,77,0,18,15,25,50,38,8,20,7,9,37,66,100,16,30,12,8,51,30,67,21,47,13,77,50,13,67,73,64,38,44,11,8,22,62,45,37,27,0,56,36,75,84,55,73,61,17,66,22,34,30,36,84,10,44,30,33,63,72,83,69,60,49,21,21,47,9,46,48,38,88,12,28,22,18,42,71,55,33,0,2,36,73,55,92,87,73,48,28,21,55,40,73,34,50,80,42,81,30,18,41,6
"2009-10-01",52,36,39,45,35,80,16,47,35,10,13,14,8,64,79,29,26,36,11,26,69,71,88,16,36,74,75,26,42,38,63,66,57,50,34,12,54,61,26,61,50,18,68,70,17,18,18,0,53,46,6,56,21,0,41,47,88,23,37,8,9,42,30,44,10,39,14,73,38,10,57,82,62,43,36,7,6,47,61,46,46,34,0,64,28,74,76,59,71,62,16,67,28,36,23,32,77,27,33,24,26,54,75,77,71,54,67,18,21,47,12,57,46,42,85,5,30,21,21,39,60,43,42,19,5,34,53,63,86,84,82,44,14,33,45,38,65,44,56,77,37,64,24,19,41,5
"2009-11-01",58,44,38,37,36,76,57,48,42,12,10,20,5,61,68,30,41,43,8,25,63,68,83,13,47,71,72,30,47,39,61,61,53,51,37,10,51,54,25,71,43,19,70,70,23,24,19,0,55,42,9,38,21,13,48,72,80,28,36,18,26,32,45,47,7,48,26,71,38,15,60,71,52,43,40,3,6,21,63,57,43,37,13,57,37,76,76,59,70,61,14,64,19,31,39,30,87,9,29,34,34,56,77,70,68,50,44,20,18,47,8,51,39,36,85,12,38,19,8,49,60,48,49,0,5,30,51,52,78,82,73,51,41,41,64,52,76,40,56,68,38,54,25,25,27,6
"2009-12-01",61,15,30,30,21,68,49,35,40,10,16,14,7,52,59,26,37,38,6,16,66,66,86,20,36,63,66,24,31,32,50,57,46,44,35,13,48,45,22,59,42,18,61,62,0,23,16,12,52,36,7,0,17,9,41,55,80,18,34,23,19,16,35,33,27,38,21,56,29,8,44,56,61,32,30,8,10,47,52,46,26,30,13,52,32,60,67,52,61,56,13,54,15,25,31,31,71,9,34,29,25,42,55,56,70,54,48,18,18,41,9,45,38,41,77,12,33,18,0,47,63,52,52,0,7,30,49,50,74,76,60,33,34,20,44,37,59,28,56,69,17,51,19,25,35,4
"2010-01-01",59,9,33,33,45,73,23,46,33,18,16,26,6,61,59,31,31,30,16,23,74,89,89,17,48,70,69,33,31,38,53,64,58,47,35,6,72,56,34,64,39,30,63,62,21,17,21,11,48,38,13,18,8,12,37,22,85,21,31,9,9,21,30,30,10,33,13,57,17,6,61,84,58,43,44,7,17,74,50,50,30,35,37,50,19,77,100,51,71,57,10,62,27,33,32,35,90,13,36,18,17,58,71,68,73,59,50,18,21,44,13,37,40,40,73,11,27,26,7,60,76,70,84,18,3,37,68,47,93,96,81,37,14,22,33,26,50,40,55,91,19,78,25,21,37,6
"2010-02-01",63,4,40,32,17,78,15,46,35,5,16,13,9,61,75,30,20,28,24,18,75,90,89,16,50,71,77,32,26,44,64,66,57,52,38,12,69,61,31,72,55,22,71,71,11,20,15,0,51,36,12,0,15,13,50,31,72,16,41,11,5,30,19,33,7,32,7,64,17,24,58,69,68,43,45,6,2,10,58,46,43,34,13,63,18,80,79,55,64,55,15,66,25,28,24,34,81,18,36,18,17,54,73,67,67,89,48,33,19,45,9,50,34,36,82,8,33,26,17,53,72,60,75,0,6,39,49,54,80,93,69,52,8,20,38,21,52,41,58,74,14,73,14,12,25,5
"2010-03-01",67,100,38,38,37,83,100,50,36,19,19,26,8,65,72,33,100,100,32,27,80,86,88,16,55,74,79,41,100,49,63,65,61,52,40,16,70,59,29,76,58,26,77,74,15,16,21,22,44,47,11,0,15,12,48,63,77,23,32,100,100,100,100,100,100,100,100,75,100,6,67,69,81,48,43,8,17,14,60,51,46,39,23,64,100,64,78,55,73,56,10,65,18,30,48,38,72,20,39,100,100,63,76,74,84,93,43,26,23,46,16,60,43,46,79,10,33,28,28,58,79,66,63,0,4,43,49,65,86,100,86,45,100,27,100,100,100,47,60,73,100,90,17,26,31,7
"2010-04-01",57,32,47,38,44,78,30,75,50,9,11,20,9,62,71,34,48,40,15,19,74,76,82,20,38,72,76,37,25,50,62,67,62,54,41,13,73,60,30,72,56,26,69,77,31,25,34,0,53,48,8,43,14,12,54,73,69,27,44,13,18,31,52,38,25,38,33,68,33,8,64,80,69,47,43,12,9,10,60,60,41,39,36,63,52,83,84,56,74,59,14,66,23,26,33,38,82,17,39,39,21,55,75,76,73,66,42,21,22,42,7,54,50,42,81,14,37,30,7,58,79,56,54,0,7,46,46,66,87,94,86,53,26,19,37,31,60,35,60,81,27,92,31,11,31,9
"2010-05-01",51,8,41,23,25,72,31,54,35,30,11,16,8,56,61,35,33,26,8,13,81,78,84,21,34,69,70,38,20,41,49,59,57,41,40,13,72,50,27,62,43,16,76,62,0,20,28,12,54,52,9,18,10,0,46,15,56,14,26,7,7,21,27,22,7,27,16,60,21,12,60,76,68,40,42,10,13,30,55,34,34,27,0,51,27,91,92,51,61,52,14,62,23,29,37,42,69,9,33,23,11,57,66,81,71,73,46,25,23,38,12,48,43,41,76,15,39,32,20,61,80,82,67,0,5,43,59,54,87,92,84,37,17,16,26,18,45,35,43,75,14,100,16,26,39,8
"2010-06-01",50,4,29,20,21,73,32,81,25,22,19,17,10,56,51,35,21,29,14,16,93,74,89,25,61,68,62,34,10,28,48,60,50,31,29,12,76,49,30,55,42,20,71,59,11,13,14,0,44,32,9,19,17,0,35,16,52,19,24,8,5,7,21,21,14,27,15,53,20,6,50,68,91,37,31,12,10,0,44,32,33,28,26,39,26,95,82,33,60,54,17,65,12,20,21,42,74,9,31,17,8,50,62,93,73,90,33,27,26,33,10,33,35,35,80,10,22,31,25,77,89,77,84,19,2,42,58,41,95,95,100,30,8,17,21,12,43,38,36,76,11,90,17,19,37,8
"2010-07-01",47,5,20,16,21,66,14,86,27,12,13,17,11,50,45,28,18,22,14,17,98,76,87,21,18,62,57,35,7,20,37,52,38,24,22,9,77,40,29,54,28,26,65,48,14,9,17,15,41,31,5,16,15,15,29,0,48,22,20,0,4,6,15,18,3,23,12,46,22,5,42,58,96,33,36,16,22,0,40,35,22,25,22,34,23,87,73,26,52,50,19,54,14,21,23,45,67,12,14,17,7,49,56,82,78,92,29,26,29,30,13,32,30,40,93,9,30,34,21,65,87,85,78,16,3,41,49,38,88,85,76,19,2,17,16,11,37,31,32,76,10,69,14,12,19,12
"2010-08-01",36,3,27,16,23,64,13,81,27,12,14,21,11,50,45,26,12,21,25,15,82,80,85,10,33,64,60,32,3,28,41,53,41,27,29,9,58,40,27,55,24,19,57,49,18,11,14,10,40,30,7,15,4,7,37,0,53,26,22,3,4,7,12,16,5,23,8,49,11,8,50,79,73,47,36,13,14,38,39,33,23,23,11,31,17,82,71,26,55,56,13,53,18,30,16,43,83,15,23,21,6,49,50,75,78,61,27,31,28,29,13,27,32,35,76,12,26,33,28,53,77,56,47,0,3,41,57,38,84,84,78,22,3,27,15,9,40,31,31,73,5,73,20,12,19,13
"2010-09-01",43,9,31,27,26,69,13,43,44,9,18,14,13,54,66,26,16,25,15,20,68,66,74,25,45,66,64,29,12,27,56,60,48,51,27,12,51,48,26,61,30,17,52,62,9,17,19,9,42,29,6,15,12,7,35,12,43,25,35,6,5,9,17,21,5,25,12,57,21,13,49,70,53,30,31,16,9,29,48,43,42,34,0,46,27,76,76,43,51,55,12,57,13,28,30,41,61,7,32,22,13,49,65,75,67,55,54,29,25,33,14,43,36,37,63,11,27,31,12,44,65,42,49,15,5,35,48,44,75,78,75,41,10,16,23,15,44,36,42,66,11,65,9,13,18,8
"2010-10-01",44,10,29,34,18,69,12,40,31,11,10,12,13,51,66,20,21,24,13,15,62,56,73,14,62,66,69,30,15,36,57,56,47,41,32,10,47,50,25,62,36,15,46,64,13,17,19,0,43,36,9,14,7,7,33,12,38,12,30,10,6,15,16,22,10,25,11,54,17,8,47,68,47,31,32,11,12,24,50,47,36,31,0,54,28,70,53,49,55,57,15,55,11,24,22,38,60,7,36,18,11,49,59,56,68,52,41,30,23,39,18,45,32,34,60,7,36,30,18,35,54,35,45,0,5,33,45,39,70,78,55,40,8,13,25,14,44,46,45,65,7,53,17,19,16,9
"2010-11-01",46,10,40,27,24,66,0,45,39,16,10,15,9,49,60,21,17,22,12,14,58,54,71,16,54,63,66,28,19,27,56,55,46,52,33,12,43,47,23,65,42,14,57,61,8,19,93,18,58,53,14,28,9,16,50,24,37,23,34,7,5,12,16,22,5,25,11,59,19,14,47,52,45,30,35,13,9,79,49,37,37,30,0,56,25,69,60,47,50,47,15,54,13,20,37,35,61,3,31,19,10,47,54,57,64,45,37,27,23,38,10,54,33,31,67,8,29,29,9,45,55,40,46,0,15,31,47,48,67,75,53,41,9,36,25,20,50,49,67,60,11,39,18,33,20,10
"2010-12-01",48,13,29,31,20,58,12,40,29,20,9,16,9,43,50,22,12,19,19,16,59,54,71,16,51,55,59,30,6,26,45,48,38,43,20,7,42,37,23,60,29,11,47,51,17,12,36,18,49,31,8,14,11,7,46,24,35,20,26,7,4,15,9,15,3,21,7,48,12,11,37,57,46,33,32,13,6,59,39,42,29,31,10,48,16,68,48,40,49,47,15,48,12,23,15,34,62,10,29,16,7,41,50,49,73,47,32,29,24,34,10,40,28,25,61,9,19,28,3,33,47,35,48,0,7,32,48,44,62,71,45,30,4,18,17,11,35,30,50,63,4,37,9,19,22,13
"2011-01-01",51,10,27,43,28,67,24,43,32,19,17,20,13,58,55,30,16,32,17,19,79,78,90,20,46,70,62,39,13,32,50,62,52,43,32,8,77,51,38,73,40,20,56,61,24,21,100,7,59,54,17,11,17,24,48,19,56,30,25,12,6,9,17,21,2,28,10,56,19,18,54,73,59,38,43,15,19,44,51,50,28,29,16,53,20,100,78,43,64,57,22,56,18,27,26,43,82,8,36,14,13,49,66,76,77,68,41,39,25,37,16,47,37,41,79,14,28,46,24,47,61,84,63,0,27,48,53,36,100,97,88,35,6,45,21,13,41,38,54,90,9,64,9,35,21,12
"2011-02-01",62,12,34,37,27,74,10,76,44,14,20,19,15,61,69,27,24,27,30,18,78,79,89,28,66,71,73,43,14,38,66,63,52,47,35,12,73,51,37,79,51,20,62,70,28,30,79,15,57,66,19,30,10,25,55,15,39,27,29,15,4,10,16,18,0,26,8,58,32,40,52,71,62,42,39,17,15,40,56,47,44,44,42,59,16,88,71,48,63,59,20,60,12,24,34,42,65,38,34,17,12,59,65,74,72,82,42,31,31,46,13,56,43,37,69,15,32,43,25,46,63,69,55,12,63,47,54,50,82,94,74,45,2,75,25,13,49,42,68,82,11,69,25,61,22,10
"2011-03-01",57,7,32,35,37,71,9,49,31,22,16,17,17,56,64,29,18,24,27,19,83,69,85,26,80,69,69,40,11,41,61,61,59,40,32,11,71,50,36,72,50,17,69,67,22,22,52,41,55,61,19,21,8,17,46,18,39,28,31,4,3,10,15,17,2,25,6,56,15,24,54,69,68,38,44,18,21,51,56,49,36,36,30,60,14,77,73,48,67,56,22,59,15,29,35,44,64,21,36,15,9,54,63,66,78,82,44,29,31,40,21,58,46,34,73,16,36,44,31,53,61,64,57,11,37,50,60,54,82,97,70,37,7,44,20,10,47,52,59,84,5,71,18,47,17,17
"2011-04-01",49,5,38,29,44,68,0,56,37,19,20,14,17,57,62,32,20,24,23,16,82,63,82,25,79,68,65,40,6,40,59,61,53,49,25,14,73,49,37,75,41,22,65,71,13,26,66,21,59,65,13,56,9,13,52,19,37,30,34,3,3,8,14,17,0,24,7,59,23,37,51,67,69,39,46,18,16,25,59,50,45,39,23,65,13,76,78,51,62,57,25,59,12,30,39,45,69,27,36,12,10,54,61,77,70,88,49,32,30,44,17,64,48,38,68,18,39,45,30,45,67,54,54,23,34,54,48,54,84,88,66,46,6,42,25,11,50,58,84,81,9,84,33,25,22,20
"2011-05-01",50,2,29,27,32,64,9,79,36,21,17,13,18,53,54,25,17,26,28,18,85,64,85,29,36,64,59,39,2,26,49,57,47,39,29,14,71,43,36,66,31,25,71,61,13,18,51,7,58,54,14,16,7,5,43,0,33,30,29,3,2,4,14,16,4,23,6,53,12,27,53,75,74,40,48,14,24,18,56,31,36,30,31,48,12,88,83,51,59,55,17,58,15,31,36,47,71,16,34,14,7,49,58,76,66,68,37,24,29,35,20,54,42,39,71,18,40,48,15,50,70,62,64,11,23,55,55,49,91,92,80,33,10,33,20,7,42,36,60,93,8,90,23,30,24,29
"2011-06-01",47,2,32,24,21,63,10,65,30,25,21,11,20,50,45,31,14,24,22,15,100,65,89,25,25,65,60,49,1,24,45,55,42,26,24,11,78,38,40,59,32,22,78,55,7,15,37,7,57,45,9,11,10,8,39,14,36,34,31,5,2,5,9,17,4,22,4,52,12,14,45,68,86,34,44,20,13,50,44,47,29,25,23,42,11,95,83,31,55,54,27,58,15,27,24,52,70,11,20,14,9,50,51,82,77,98,35,27,36,31,20,39,31,34,79,18,24,49,14,66,77,93,75,23,16,54,61,36,100,90,88,27,4,24,20,9,44,34,49,94,5,81,15,29,18,24
"2011-07-01",38,2,27,27,25,59,9,100,28,30,24,17,19,48,40,29,9,23,31,16,99,66,88,31,51,60,58,42,6,27,39,50,36,22,19,10,83,38,41,59,32,17,76,53,6,15,23,11,46,40,9,11,6,10,40,18,35,39,23,5,2,8,9,14,0,21,5,48,14,10,39,67,92,35,40,21,22,37,43,42,25,28,8,41,10,92,83,24,52,56,30,50,13,23,22,53,74,22,13,13,7,41,51,86,74,92,28,32,37,28,18,34,28,37,83,14,33,50,23,66,86,88,90,0,15,58,55,27,95,89,81,31,2,37,15,8,38,39,48,77,5,85,14,34,16,24
"2011-08-01",40,1,30,14,13,62,13,90,27,16,20,14,15,51,41,31,12,22,29,13,91,72,85,28,51,63,58,47,6,25,40,53,43,28,24,12,68,39,35,65,30,17,65,53,12,17,38,13,52,40,10,21,9,14,38,9,36,29,19,4,2,2,10,15,6,22,4,49,14,15,49,64,73,34,35,21,21,46,43,35,23,29,0,36,10,91,75,28,50,54,29,52,8,23,20,52,87,20,18,13,8,47,56,100,81,65,27,27,32,31,19,30,26,35,90,14,25,48,24,52,70,52,72,0,12,53,56,34,97,89,93,30,5,24,18,5,37,37,48,87,5,81,16,24,15,34
"2011-09-01",45,2,32,33,26,65,17,44,43,17,25,18,16,55,62,28,13,23,20,14,76,61,80,27,34,66,60,38,5,32,57,58,46,42,31,15,58,49,34,67,53,17,62,66,12,18,26,16,54,38,8,25,6,0,41,13,28,33,28,5,2,7,9,17,2,24,6,55,12,15,51,68,53,30,29,20,16,17,55,55,50,44,14,46,11,85,68,40,56,56,23,56,14,27,28,46,74,13,36,11,9,55,65,69,70,49,42,29,30,33,19,45,33,31,74,16,31,44,22,42,61,47,48,21,11,50,54,46,87,86,69,38,5,29,22,5,48,37,52,77,9,68,21,15,16,25
"2011-10-01",56,8,35,35,25,64,8,41,35,16,17,19,17,55,63,23,12,24,43,16,68,56,78,24,54,65,66,34,8,36,59,57,48,40,26,11,53,48,31,74,45,14,57,65,29,19,32,19,55,43,11,24,7,9,43,12,27,27,40,3,2,12,10,20,2,24,5,58,17,9,47,59,45,32,36,16,13,54,54,59,45,51,34,58,11,89,62,47,58,51,24,56,12,21,35,43,65,26,36,15,9,53,62,59,67,53,29,22,33,37,22,59,43,27,73,13,27,41,19,42,54,52,41,40,18,48,48,43,80,80,69,42,7,33,21,9,44,46,57,69,9,62,13,21,9,15
"2011-11-01",57,2,28,35,25,63,17,42,40,14,15,18,15,52,55,22,12,26,19,14,60,55,75,20,38,62,59,34,12,32,56,54,45,43,33,12,46,46,31,76,43,13,50,60,12,24,39,22,58,45,10,15,4,14,43,12,24,32,29,4,2,13,13,19,0,23,5,56,18,13,46,58,41,33,33,15,19,46,54,58,44,50,20,52,13,72,65,46,52,51,28,52,10,20,28,40,74,14,32,12,8,45,60,57,64,55,34,19,29,32,25,59,35,31,69,15,22,36,18,33,51,37,32,30,17,44,49,43,73,76,60,49,3,40,22,8,47,43,57,69,6,51,13,18,16,19
"2011-12-01",41,4,22,24,22,53,8,38,27,23,27,16,16,42,44,22,11,18,23,11,65,56,78,30,35,55,51,34,2,26,41,48,33,35,23,9,44,37,29,65,38,12,50,47,11,18,22,6,53,36,8,14,11,13,38,8,19,26,25,2,1,7,8,14,3,19,4,42,12,9,36,53,45,26,28,16,21,49,45,41,30,32,32,43,9,70,50,38,45,48,21,46,10,22,21,39,66,16,24,11,6,39,42,58,63,62,32,22,28,28,20,44,31,26,72,18,25,34,17,29,47,39,38,0,4,41,37,33,66,70,50,26,3,27,17,5,37,38,48,59,13,43,4,12,8,26
"2012-01-01",47,4,32,24,14,61,29,38,32,31,22,17,20,53,47,28,9,22,22,16,71,66,82,31,33,60,59,43,5,29,48,55,46,36,24,9,67,46,41,82,38,20,60,53,5,15,28,6,52,42,10,17,4,6,34,7,30,35,22,2,2,6,8,15,3,22,5,53,13,13,47,77,49,31,31,17,14,43,46,48,36,36,18,43,11,78,76,43,56,49,31,52,9,22,24,45,75,21,32,12,6,50,59,76,70,70,38,22,32,31,26,38,33,32,78,23,33,51,21,41,58,62,51,0,13,54,49,39,86,91,72,33,5,29,18,8,41,47,50,86,7,70,12,26,18,33
"2012-02-01",53,6,38,45,29,67,15,45,33,31,28,16,18,53,61,28,14,25,21,14,75,71,83,34,64,64,65,42,7,36,61,58,45,39,30,10,62,46,43,76,44,17,69,63,21,20,27,6,55,39,8,36,8,12,42,26,32,39,28,9,2,14,14,15,3,22,4,59,14,14,45,60,49,37,38,26,24,32,54,58,51,37,12,60,8,82,60,45,55,50,32,54,13,27,27,46,63,9,36,14,9,51,61,61,75,68,41,25,31,34,22,61,35,36,66,24,31,50,22,49,62,65,58,0,12,57,42,51,73,88,67,40,3,34,21,6,42,47,62,69,8,65,6,17,11,29
"2012-03-01",49,8,34,28,29,65,7,44,32,27,28,11,23,50,56,27,17,31,23,14,79,64,81,40,65,61,59,48,10,39,56,59,48,41,26,11,65,43,45,67,42,20,67,59,13,21,24,14,54,48,8,17,10,12,42,29,28,31,33,4,3,12,13,18,3,25,5,56,18,15,46,50,55,35,37,23,27,44,48,51,43,33,18,54,12,79,63,43,56,50,35,51,12,24,29,48,69,38,34,13,12,48,59,57,71,78,41,23,35,32,23,58,43,34,67,24,22,51,26,41,61,65,57,0,10,63,51,48,73,90,64,32,6,22,26,8,44,46,55,76,8,74,19,24,15,34
"2012-04-01",54,6,34,30,37,61,11,49,31,30,24,15,22,52,59,26,16,23,25,13,74,62,78,32,56,63,57,48,6,32,55,55,45,44,23,11,67,45,46,75,40,16,69,64,5,23,28,11,54,46,7,13,6,6,47,15,30,34,41,3,2,12,12,15,2,22,5,55,19,11,49,57,49,39,43,26,29,30,57,47,49,39,12,62,10,82,65,44,55,54,30,52,9,25,31,49,72,15,36,13,8,51,61,69,70,63,44,24,33,30,26,68,40,34,65,27,25,55,32,38,67,59,35,18,14,65,50,44,80,86,67,30,6,33,24,10,46,37,52,71,8,81,15,29,9,33
"2012-05-01",45,11,28,27,22,59,0,46,29,34,26,13,25,49,49,27,11,23,31,10,84,64,80,34,52,61,57,50,4,30,44,53,43,35,22,7,63,38,47,61,35,16,68,59,8,15,25,16,53,46,6,13,7,8,61,14,27,30,28,5,2,9,8,12,2,20,4,51,14,15,47,59,56,35,31,28,30,17,48,39,35,38,12,46,7,89,75,52,54,49,30,53,8,25,25,52,69,6,27,14,6,46,54,68,65,67,37,28,38,26,29,48,37,30,67,27,29,58,28,47,68,51,52,9,6,60,53,41,88,87,78,36,3,37,17,5,43,46,49,79,9,93,13,23,10,37
"2012-06-01",44,8,21,26,28,56,8,61,29,28,28,20,24,47,42,25,14,48,29,7,94,64,86,37,54,58,53,52,9,23,39,51,36,25,16,10,66,34,46,64,35,16,73,51,5,10,13,6,51,45,3,18,8,4,38,19,25,35,19,4,4,14,11,21,10,33,7,48,22,11,40,57,65,35,35,36,37,47,37,27,30,35,6,40,15,96,68,29,46,50,31,49,10,24,25,58,66,26,20,17,25,44,49,79,70,66,27,23,41,25,32,38,29,33,73,30,27,58,31,55,75,84,62,9,3,60,56,29,90,87,73,26,7,29,28,10,46,35,45,78,12,89,14,19,12,33
"2012-07-01",38,7,27,23,14,55,0,60,31,28,35,18,27,48,39,25,11,28,44,9,95,68,85,39,49,57,51,48,5,26,36,47,32,22,14,12,72,34,45,69,34,17,71,48,20,14,18,5,53,47,7,13,9,4,37,11,27,39,23,7,4,10,6,20,6,24,6,47,14,15,36,73,65,27,32,36,36,33,40,37,29,28,12,33,13,82,64,23,48,47,36,47,8,23,19,62,74,19,17,12,10,44,50,81,69,79,25,27,45,23,31,35,28,31,78,23,29,64,25,57,77,69,62,17,17,62,48,27,90,89,79,21,5,35,23,7,38,28,39,75,5,90,23,26,10,41
"2012-08-01",48,3,25,25,25,55,7,52,25,36,35,17,22,48,38,25,9,25,28,9,86,69,84,38,36,59,54,49,3,28,35,50,37,29,18,8,57,37,47,70,33,15,57,48,10,14,19,21,52,48,7,8,7,0,39,7,26,38,16,3,2,8,6,17,6,21,4,52,12,8,48,57,54,26,26,34,36,32,38,42,28,27,11,32,9,91,62,24,50,50,47,48,9,27,17,60,81,8,20,14,8,44,51,73,73,53,18,23,40,22,32,31,25,30,80,25,24,59,25,47,63,48,47,25,12,58,55,30,86,86,80,23,1,18,17,5,35,37,44,81,6,80,13,30,12,44
"2012-09-01",42,6,36,39,27,60,0,27,33,26,27,15,22,52,60,23,12,24,31,11,70,65,78,38,51,60,58,44,5,34,60,54,38,41,21,9,46,47,43,81,47,13,55,65,13,18,28,16,61,49,9,8,6,8,48,14,28,33,33,3,2,6,11,18,2,23,4,59,20,13,47,67,40,32,32,32,41,35,49,60,45,41,18,57,9,89,59,38,51,46,39,57,12,31,25,54,72,21,35,12,8,47,62,69,66,43,35,24,38,29,29,55,37,30,74,26,38,55,35,44,57,35,36,17,16,56,47,39,82,82,68,39,4,44,25,7,46,50,60,76,9,76,23,21,10,37
"2012-10-01",50,2,30,43,35,61,0,27,38,21,27,12,17,52,62,21,13,27,23,8,65,53,74,36,54,62,61,48,4,29,62,54,41,41,24,10,38,48,41,78,45,14,49,61,5,20,28,15,59,44,8,23,5,7,45,13,24,32,35,3,2,8,10,20,3,24,5,58,15,14,44,52,34,31,28,33,28,48,49,57,44,39,16,63,10,80,58,43,50,46,33,75,11,22,26,49,68,17,32,13,8,49,58,52,64,42,36,25,32,33,29,73,38,25,62,26,22,51,34,35,48,30,24,31,13,49,44,44,76,77,65,44,4,37,26,6,45,56,59,63,7,53,14,23,8,27
"2012-11-01",51,5,29,28,22,52,0,14,30,27,23,15,20,51,54,19,15,30,29,9,58,53,73,34,61,54,50,39,7,27,53,48,37,37,22,10,35,41,40,78,42,11,54,53,5,25,29,15,61,43,9,12,4,4,42,7,21,36,33,2,2,11,8,20,1,23,5,60,18,7,41,52,32,29,26,25,25,49,50,56,43,36,28,52,14,75,51,43,48,45,40,69,8,20,26,47,64,14,31,14,10,44,50,53,58,35,30,20,35,28,22,66,39,23,66,24,27,48,23,32,48,28,30,8,7,46,37,38,67,70,54,40,8,20,26,7,45,58,56,65,12,37,12,23,13,29
"2012-12-01",40,3,24,22,18,47,7,33,30,22,28,15,21,39,43,17,8,21,28,7,57,52,75,33,38,47,61,37,2,24,44,44,31,29,18,7,34,34,41,63,31,9,51,48,7,13,16,10,53,35,6,27,4,0,32,19,18,23,22,2,1,5,5,12,1,17,3,43,9,10,31,46,31,23,28,26,31,43,43,50,36,33,11,45,8,61,38,36,41,42,34,44,8,18,24,46,55,17,26,12,6,36,39,39,58,49,23,23,33,27,27,50,33,26,62,23,26,46,21,28,47,30,30,0,5,45,34,27,58,67,47,29,2,24,16,5,34,45,48,58,4,36,16,10,9,29
"2013-01-01",47,3,26,32,22,58,0,24,32,37,33,17,23,50,50,23,10,23,22,9,70,58,77,38,65,57,60,49,1,28,46,53,42,37,22,8,58,42,55,82,41,14,57,53,11,15,20,9,52,40,5,18,7,3,39,9,30,42,27,5,2,10,7,14,5,21,4,50,12,10,42,58,37,33,32,39,32,52,46,48,37,36,5,47,9,90,64,41,55,44,44,55,11,24,23,49,76,16,29,12,7,45,53,61,75,54,35,22,32,25,31,47,29,33,67,35,29,71,28,43,55,58,47,7,10,57,44,34,83,85,72,29,3,15,16,5,41,44,49,73,2,52,18,22,8,32
"2013-02-01",57,3,41,49,34,63,0,23,40,22,29,13,22,49,61,23,12,26,33,10,71,66,79,50,70,59,69,48,3,36,59,54,45,36,22,6,49,44,50,82,49,15,51,63,14,13,23,15,58,41,5,23,8,11,43,13,25,39,32,5,1,11,10,14,4,20,5,55,14,9,42,58,41,38,36,34,47,41,52,54,52,37,11,65,10,74,56,45,52,49,40,57,9,25,25,50,60,17,32,11,8,50,57,50,71,56,42,26,37,30,34,67,39,28,58,37,24,69,37,39,55,47,36,8,7,62,39,44,74,85,59,36,2,32,19,5,43,62,66,70,8,54,17,23,12,32
"2013-03-01",51,4,31,41,38,59,6,29,35,38,40,18,28,47,56,26,9,27,42,9,78,60,78,54,59,60,65,43,5,33,56,53,43,41,20,8,56,42,54,79,51,13,59,61,17,14,23,14,59,48,8,28,9,3,43,12,29,35,32,3,2,7,5,12,1,20,4,55,12,11,43,53,47,36,37,44,51,33,49,60,46,34,15,59,11,87,65,46,53,46,47,55,14,23,27,54,63,10,30,10,10,46,56,49,71,59,38,23,43,30,37,65,33,34,68,33,32,72,32,40,59,52,37,0,8,67,44,38,77,88,58,28,4,19,21,4,42,49,56,67,7,59,9,21,8,48
"2013-04-01",52,4,37,41,32,62,6,31,34,38,30,15,25,50,60,27,13,26,33,8,71,55,74,39,61,60,82,51,6,34,56,54,42,42,19,9,52,42,59,81,42,15,66,64,11,16,23,19,59,46,8,36,5,10,43,27,27,41,36,4,1,4,8,13,4,21,5,57,15,11,47,59,39,38,40,36,35,46,51,48,46,35,15,64,12,75,64,45,52,44,46,55,6,24,33,54,67,14,34,12,8,51,55,54,66,55,40,21,40,31,35,79,42,37,61,34,36,74,51,45,57,46,40,7,6,70,46,48,84,84,63,39,2,22,20,5,43,57,70,77,11,65,10,24,9,51
"2013-05-01",45,2,29,28,32,58,19,25,31,43,39,21,24,46,48,25,13,26,42,12,78,58,77,43,54,61,56,49,9,30,48,51,38,36,22,10,51,37,51,67,40,17,69,55,0,12,16,14,61,52,6,25,3,3,48,18,27,43,25,2,1,6,8,13,0,19,4,49,12,14,44,63,46,37,36,44,48,46,50,42,40,27,10,49,10,86,64,41,47,47,48,53,9,24,22,57,63,14,31,8,7,46,48,66,61,60,51,20,41,26,38,56,31,33,61,37,31,79,31,48,62,47,42,7,6,68,44,41,84,80,69,30,1,34,16,4,36,47,52,79,6,70,10,28,9,53
"2013-06-01",37,2,23,27,24,54,7,42,23,29,41,16,30,42,39,24,9,22,39,10,92,60,82,52,34,55,53,51,8,24,36,48,32,24,13,12,54,31,56,59,25,13,64,48,7,7,15,15,56,41,4,27,3,7,31,6,23,42,21,2,1,5,6,12,4,19,3,46,14,6,38,66,54,34,35,50,57,32,38,37,30,23,5,40,10,88,63,27,40,46,48,47,10,28,18,65,64,13,18,9,6,41,49,54,71,71,31,23,45,23,41,40,23,30,67,49,26,81,37,57,63,67,54,0,2,69,45,28,87,80,65,18,2,21,15,4,36,47,42,79,8,70,10,21,7,53
"2013-07-01",42,1,24,25,27,54,6,53,25,30,41,17,28,42,36,27,8,27,43,7,91,62,83,46,30,54,51,55,3,25,36,48,28,22,11,7,55,32,60,66,31,12,55,45,4,10,14,9,52,42,3,18,4,7,40,6,25,39,16,2,1,2,5,13,0,20,3,47,10,5,33,69,61,36,36,56,57,49,40,36,27,22,10,33,10,90,72,22,45,46,54,45,11,29,16,69,69,18,15,16,8,41,47,58,70,86,28,18,51,22,35,37,25,36,77,41,27,84,37,52,66,67,55,0,5,70,45,28,89,81,71,18,0,14,14,3,34,44,41,78,3,64,6,14,11,49
"2013-08-01",42,2,19,15,22,54,12,43,20,43,37,15,30,42,36,25,7,26,41,7,81,62,79,45,47,56,49,55,3,23,35,49,33,23,16,9,49,34,58,62,30,13,61,44,4,9,17,9,52,46,3,7,5,7,37,9,27,46,17,6,1,8,6,14,3,20,4,48,13,5,43,67,51,33,30,49,56,32,41,27,22,22,0,30,10,82,65,24,45,48,57,45,9,27,19,67,76,9,22,12,7,44,47,53,71,56,24,22,43,21,33,31,23,33,77,44,30,79,34,46,60,52,37,7,2,69,43,31,84,79,71,18,1,15,16,5,33,35,40,74,10,61,11,18,8,48
"2013-09-01",46,4,33,45,32,60,0,29,32,43,39,17,28,50,58,23,12,37,35,7,71,56,74,37,47,60,57,48,7,32,62,53,36,41,18,8,39,45,50,76,42,8,63,62,9,13,20,14,57,41,6,14,6,7,42,15,22,46,32,3,2,13,9,21,4,25,5,56,28,12,44,64,37,33,28,47,55,36,50,57,54,35,0,51,16,85,54,39,48,45,55,50,8,27,24,61,62,4,32,19,11,46,51,48,64,50,39,23,40,27,37,61,38,32,66,35,34,70,46,42,52,39,31,7,3,63,44,37,80,81,58,39,1,21,22,6,47,53,50,68,11,53,10,10,8,54
"2013-10-01",52,2,28,44,27,63,0,21,37,42,35,14,21,52,64,22,19,54,36,12,63,51,72,37,72,63,69,49,10,28,65,59,40,42,22,9,34,51,45,85,50,13,52,65,12,13,20,18,61,40,7,17,5,8,43,43,19,42,34,2,2,10,11,30,0,34,6,63,27,10,43,69,36,34,25,46,44,48,51,65,49,33,14,63,17,69,50,47,52,44,44,51,6,27,24,55,65,8,38,24,19,55,57,49,61,42,37,24,40,31,39,73,45,31,56,40,28,66,33,32,45,33,30,7,7,57,35,41,76,80,60,47,4,25,29,6,54,65,66,63,16,42,6,18,8,53
"2013-11-01",52,3,34,34,28,58,0,27,33,33,41,15,25,48,54,20,10,37,49,9,62,49,71,37,61,57,57,50,4,37,62,50,33,43,17,11,34,43,42,82,56,13,47,56,4,12,16,11,67,47,8,18,7,7,42,12,21,39,31,1,1,12,7,23,1,25,5,61,26,11,40,64,35,29,32,44,44,70,51,54,42,32,5,54,11,72,45,44,44,40,60,46,8,23,24,52,62,5,32,19,14,47,52,41,61,41,34,25,36,26,35,68,39,28,55,35,31,62,41,36,46,31,27,15,5,54,34,39,64,75,50,35,1,31,24,6,47,61,56,60,14,34,11,20,5,45
"2013-12-01",39,0,29,26,28,51,0,22,30,32,36,15,27,40,44,22,7,30,44,7,61,49,74,42,48,48,51,44,2,28,49,52,30,34,17,8,33,34,43,70,31,13,42,46,8,9,18,7,61,39,6,14,2,8,38,6,17,38,25,4,1,9,6,20,0,22,6,45,17,10,32,51,35,27,27,36,45,57,44,54,35,29,0,48,8,69,53,39,41,40,61,40,7,23,23,50,60,12,25,19,9,39,37,42,57,37,30,24,36,28,31,56,33,26,61,30,21,58,30,32,45,36,35,7,5,52,34,31,59,67,42,27,1,29,18,4,37,51,58,57,5,29,15,20,7,39
"2014-01-01",44,1,41,29,26,60,6,23,24,29,37,15,30,50,47,24,11,30,56,9,72,57,76,52,66,58,57,56,2,31,49,55,39,36,18,9,49,42,56,87,41,15,53,54,12,8,15,13,58,38,5,20,7,5,45,6,28,51,21,4,1,6,7,18,1,22,4,54,14,7,42,76,41,38,34,43,41,54,48,56,42,32,9,47,8,89,74,40,50,41,62,49,5,29,20,57,69,7,31,14,10,45,52,50,67,57,39,28,41,28,35,49,27,31,63,44,33,80,35,37,54,55,45,7,6,64,42,33,82,87,62,24,2,18,17,3,40,60,58,74,9,51,21,27,9,53
"2014-02-01",52,2,41,41,42,65,0,27,36,38,41,17,32,52,62,22,13,26,43,12,71,68,79,45,59,60,63,52,3,36,66,55,39,37,18,9,47,44,56,86,43,19,55,65,7,13,23,9,60,43,7,15,6,3,40,9,28,47,34,3,1,8,10,17,0,22,4,55,16,11,42,66,45,38,34,50,43,29,53,49,63,39,10,62,8,74,59,46,48,45,62,51,7,32,26,58,68,13,36,15,7,56,52,46,61,60,36,23,40,33,35,69,42,33,62,40,34,83,37,42,54,51,39,22,10,67,36,39,72,83,61,37,1,33,20,2,41,58,62,66,7,50,15,21,6,56
"2014-03-01",54,2,33,38,31,63,6,29,33,42,47,19,35,49,55,27,13,33,62,9,76,59,78,57,74,59,57,53,3,31,59,54,38,40,20,10,49,43,58,83,40,18,53,57,6,11,25,6,60,51,7,10,4,6,37,5,26,45,30,5,1,8,7,20,0,25,5,55,12,19,43,65,45,35,35,61,51,35,48,58,46,33,18,56,8,84,63,42,49,43,63,48,7,28,28,58,67,6,28,16,9,49,50,39,65,59,41,22,51,28,37,67,35,33,60,44,32,86,45,43,54,48,32,20,11,75,36,42,73,85,49,38,2,29,20,3,44,54,63,68,5,58,12,26,11,62
"2014-04-01",60,3,38,39,41,65,0,26,31,38,49,18,36,49,61,25,10,28,64,11,72,56,75,47,69,60,58,53,2,36,60,55,38,41,18,12,45,44,59,81,40,19,51,63,8,16,28,20,64,54,9,24,8,6,44,20,25,46,36,3,1,9,6,16,0,22,4,59,18,14,44,62,46,42,37,56,55,38,54,61,51,36,24,64,6,70,56,44,49,46,60,50,7,30,31,61,72,8,35,14,7,48,53,46,62,48,44,22,43,30,43,75,41,35,61,48,39,85,56,38,55,43,30,7,12,76,41,49,78,82,58,41,0,33,19,2,44,62,70,68,6,51,11,25,9,65
"2014-05-01",53,3,29,26,29,57,0,28,27,47,44,13,32,47,50,22,8,24,52,8,78,53,76,59,66,60,53,59,2,29,51,52,33,36,20,10,45,39,58,69,31,18,67,55,9,13,30,14,63,52,6,14,5,5,48,12,24,50,31,3,1,8,3,13,0,19,5,51,11,11,44,61,48,37,33,59,56,24,53,37,37,28,20,50,5,70,63,42,45,46,76,48,10,31,28,66,72,2,34,12,6,43,49,42,61,55,40,25,48,26,42,61,26,34,61,45,30,86,56,44,55,50,40,29,11,79,39,43,80,81,56,29,1,39,16,3,41,50,63,73,3,59,9,22,9,72
"2014-06-01",40,0,24,25,31,58,7,29,21,42,50,17,37,42,41,27,10,23,56,8,86,55,79,57,59,59,52,69,3,27,38,50,33,23,14,10,48,33,57,67,31,13,62,51,5,11,23,13,57,48,4,29,5,8,37,14,23,54,20,3,1,3,7,14,0,19,4,49,12,11,37,64,60,32,30,69,71,41,41,38,34,23,17,40,4,72,56,28,41,44,81,47,9,28,28,72,65,6,19,10,6,45,49,49,64,66,32,19,52,24,44,41,26,34,66,50,29,86,55,55,59,65,46,0,9,78,36,33,80,81,62,22,1,21,14,2,37,37,46,69,8,55,12,26,9,71
"2014-07-01",42,2,31,28,19,59,14,48,22,44,56,18,38,46,38,28,8,25,49,6,95,60,81,74,41,57,51,65,1,29,38,51,29,21,14,12,49,37,66,64,27,15,55,47,5,8,20,5,56,51,3,20,9,0,32,13,23,60,19,2,1,6,5,14,0,20,3,51,11,12,31,69,63,38,28,72,67,40,42,32,36,22,5,39,4,80,57,23,42,45,80,44,7,29,17,76,63,12,15,11,7,44,46,54,75,60,25,25,57,23,43,39,25,32,71,49,33,92,49,56,66,73,47,0,6,79,41,33,83,82,65,16,4,21,13,2,36,37,43,70,0,59,11,18,8,74
"2014-08-01",37,1,23,16,19,55,0,46,23,45,62,21,44,42,37,25,9,22,53,8,80,61,76,51,48,55,51,64,2,28,37,50,30,23,17,12,43,34,61,66,30,26,48,48,7,8,18,0,58,44,4,31,5,4,33,7,20,60,15,5,1,9,5,14,1,19,4,51,10,11,41,64,56,33,28,68,49,44,41,35,32,22,6,32,3,78,54,25,42,45,80,44,8,32,17,74,72,8,19,8,6,43,44,38,70,50,22,22,56,21,44,32,19,31,62,49,34,85,56,37,57,45,31,0,1,76,38,30,78,78,62,17,1,25,12,2,36,37,40,68,4,51,13,16,11,80
"2014-09-01",52,0,38,35,30,67,6,21,42,46,47,12,33,50,62,22,12,26,46,9,65,54,70,46,84,62,58,58,0,34,65,57,37,40,22,10,34,48,61,69,45,15,48,68,4,11,24,10,66,44,6,19,4,5,44,16,19,48,31,3,1,5,9,14,0,21,5,60,15,11,44,60,37,35,26,54,45,53,56,44,64,35,11,51,4,82,57,39,48,46,78,49,7,33,21,65,63,13,36,13,8,53,58,40,67,38,43,20,45,28,43,58,37,30,56,44,33,82,53,36,47,40,23,8,5,68,31,43,74,78,53,35,1,27,17,2,44,45,53,66,10,45,8,18,10,61
"2014-10-01",47,1,32,37,48,66,6,17,36,43,46,10,30,50,65,23,13,25,67,10,60,48,68,43,75,63,67,58,2,37,68,56,35,42,24,10,31,47,59,78,42,15,53,62,9,14,17,18,59,46,8,11,3,3,46,12,19,50,38,2,1,7,8,17,0,22,4,58,15,14,41,60,37,39,29,57,66,32,60,56,58,40,20,66,5,69,50,47,46,43,63,48,7,29,24,59,59,9,40,14,8,50,58,40,60,40,36,19,47,34,39,87,47,33,60,46,31,73,45,35,47,33,16,36,2,67,40,48,65,75,48,38,0,34,18,3,47,51,54,63,4,39,19,17,8,55
"2014-11-01",53,2,34,43,38,58,0,11,33,38,43,12,35,47,51,18,10,26,61,8,55,46,66,52,75,53,51,51,3,31,58,51,29,42,20,11,28,42,56,77,39,13,41,57,0,12,20,5,66,48,7,8,3,5,45,19,18,46,33,2,1,7,6,18,0,21,4,56,15,10,37,50,31,33,26,54,62,63,53,52,55,36,11,55,6,63,43,45,45,44,62,44,6,25,23,54,62,11,32,16,7,48,47,38,54,31,31,23,43,28,37,72,38,28,58,38,22,70,36,28,40,31,23,0,4,63,30,40,59,70,37,33,1,26,19,3,44,45,56,58,5,30,12,22,7,57
"2014-12-01",45,1,32,31,29,53,6,19,20,40,44,12,38,42,46,16,7,20,47,9,57,43,69,53,66,50,49,53,1,26,46,47,28,35,15,8,27,33,50,67,31,11,38,50,11,11,16,5,58,43,5,7,3,0,35,16,16,48,29,5,1,4,4,17,0,20,5,48,12,11,31,50,31,33,25,60,41,48,48,41,37,29,5,52,4,65,45,39,37,40,66,40,3,25,21,52,55,5,29,17,6,41,42,36,64,43,28,17,44,28,41,57,32,24,55,41,25,64,28,29,37,34,25,8,5,56,25,36,57,66,38,30,2,31,14,3,38,50,54,55,2,30,13,20,8,58
"2015-01-01",47,1,30,35,28,61,6,15,29,38,41,14,38,47,46,21,9,24,54,9,66,54,72,53,47,54,55,56,4,32,50,52,35,35,18,9,37,38,67,86,36,23,48,52,6,9,19,5,59,44,6,25,1,5,36,15,24,56,27,7,1,2,7,16,0,21,5,53,15,11,40,58,38,37,36,59,55,58,50,52,36,34,20,48,5,86,62,43,48,42,61,44,8,26,23,57,69,0,31,14,6,47,46,54,62,54,30,23,49,30,47,45,27,31,60,57,36,89,37,34,48,58,40,0,4,72,33,37,71,80,50,28,1,24,14,1,40,48,54,63,1,47,19,21,6,67
"2015-02-01",51,1,43,61,49,67,6,17,35,49,49,15,37,51,62,21,12,28,65,10,71,60,73,61,90,59,67,65,2,36,65,58,38,42,23,8,39,43,67,86,42,24,46,69,9,10,17,17,63,46,5,11,3,4,38,19,24,56,36,2,1,6,7,17,0,22,6,58,12,9,41,55,36,36,31,66,66,42,53,60,65,43,11,69,5,67,51,47,47,44,63,49,8,32,27,58,62,9,34,14,7,52,48,40,61,49,46,24,48,32,45,82,44,33,56,60,25,87,32,34,50,50,36,0,5,74,32,44,67,82,44,45,1,18,16,2,43,56,64,64,5,45,17,23,9,67
"2015-03-01",55,1,36,42,44,65,12,15,30,53,47,16,39,49,59,24,9,25,54,12,74,56,73,60,53,61,60,67,2,38,60,56,39,38,23,10,42,41,74,79,37,23,46,65,4,13,15,21,62,46,7,22,5,7,45,15,24,56,33,6,1,4,7,15,0,20,4,57,18,7,41,57,45,42,38,76,90,41,54,55,53,37,10,65,5,71,55,45,49,45,73,48,7,34,28,60,66,5,40,12,6,53,49,45,60,55,42,24,52,33,46,82,44,36,55,56,32,91,58,39,54,51,32,7,4,82,33,42,66,87,46,31,0,29,14,3,42,50,56,66,0,48,13,24,10,81
"2015-04-01",53,0,37,42,45,69,13,17,31,47,59,14,41,49,62,27,11,24,59,9,64,53,67,74,63,60,61,70,2,41,62,57,35,41,22,10,38,43,68,86,46,22,53,67,4,13,18,10,69,57,6,60,6,9,48,12,25,55,40,2,1,5,6,13,0,20,5,57,15,8,42,51,39,48,36,65,63,31,59,53,53,39,15,65,6,67,57,43,50,44,61,50,11,32,33,63,70,2,38,11,5,52,55,43,62,45,35,19,52,30,50,82,42,35,51,60,40,90,70,40,56,45,24,15,4,88,29,48,67,80,46,37,1,21,18,3,44,56,66,65,5,52,12,11,8,77
"2015-05-01",44,0,31,43,29,60,0,26,28,63,60,11,49,45,46,24,9,23,91,7,73,54,70,70,59,56,55,78,1,30,48,49,33,33,18,7,41,34,68,69,30,19,53,54,7,12,13,10,64,58,6,19,4,4,38,13,17,53,26,3,1,7,8,12,0,18,5,49,12,10,42,48,37,42,31,78,81,32,51,37,45,28,5,52,4,75,55,40,45,47,71,45,10,31,24,68,66,11,31,9,4,41,45,42,60,54,40,21,53,26,50,61,36,34,51,56,36,93,58,42,54,49,30,8,1,90,32,39,71,75,50,32,3,26,15,3,37,52,54,61,0,53,9,24,8,82
"2015-06-01",43,1,29,35,30,62,0,34,28,54,67,12,47,44,41,25,8,25,95,8,79,57,75,77,50,60,55,90,2,25,38,51,33,23,16,11,42,35,75,64,32,21,60,54,5,7,13,10,62,57,4,8,3,4,37,10,19,62,20,3,1,3,6,14,0,19,5,50,14,7,35,63,52,36,32,92,88,38,42,38,38,25,22,40,4,82,54,26,41,48,91,45,7,34,18,76,60,2,17,12,6,46,44,44,64,62,29,27,63,24,56,43,25,32,61,56,26,98,73,51,59,62,32,16,4,92,39,33,74,76,54,23,2,16,14,2,36,36,41,67,5,46,9,24,6,78
"2015-07-01",40,0,22,25,15,61,7,29,26,76,61,13,60,43,39,26,7,24,92,7,88,56,80,80,49,58,51,89,3,26,34,51,27,20,10,10,44,33,75,66,27,22,49,46,5,6,21,12,64,58,4,8,6,0,35,13,22,61,18,2,1,5,4,13,0,19,5,49,15,10,32,58,60,37,35,91,91,52,41,32,32,26,11,37,4,85,56,23,38,48,89,43,8,34,20,84,61,2,17,10,6,43,45,42,71,64,24,24,67,25,54,39,25,34,60,66,36,100,89,51,66,70,36,0,4,94,31,26,76,76,57,26,0,21,12,2,38,42,40,76,2,51,10,26,8,95
"2015-08-01",40,0,27,27,19,58,0,27,22,47,67,19,53,44,36,22,8,22,89,7,75,60,76,68,49,58,50,66,1,31,36,52,30,26,16,11,39,32,78,68,27,21,46,50,9,8,15,7,63,52,5,12,6,4,46,6,22,70,16,2,1,2,5,15,0,19,4,49,10,9,41,63,48,34,33,83,83,45,40,35,33,21,5,35,3,83,52,25,40,50,84,44,6,38,21,79,64,8,20,11,5,42,42,48,72,50,23,19,65,26,56,34,25,35,64,59,37,95,65,41,59,51,27,8,1,93,35,30,77,76,50,20,1,36,11,1,34,35,40,77,5,44,7,22,7,93
"2015-09-01",51,0,43,38,34,66,0,15,45,49,51,15,43,50,60,21,10,21,62,9,66,54,69,60,68,62,59,71,2,35,68,56,35,40,21,9,30,45,66,74,34,17,52,70,22,11,20,10,64,56,6,22,8,5,47,6,18,62,36,5,1,7,8,15,0,20,4,57,16,10,45,59,38,37,31,76,72,29,54,45,71,36,16,54,3,77,50,43,46,47,80,48,8,37,31,71,69,2,40,11,6,47,52,39,58,35,38,20,55,31,50,65,44,33,53,51,39,82,69,35,51,36,22,8,3,80,31,44,68,74,48,47,1,16,18,3,45,50,57,66,7,41,5,21,4,85
"2015-10-01",51,2,43,41,38,64,12,13,38,43,55,11,45,50,63,21,13,25,80,10,60,46,68,59,58,62,68,62,0,35,68,56,37,38,21,10,27,47,66,82,44,19,47,64,11,10,21,16,70,51,7,21,7,7,52,18,16,56,40,4,1,5,11,17,0,21,6,60,13,10,41,55,31,40,32,72,91,47,55,64,71,34,20,66,4,73,49,48,48,45,66,49,9,35,29,61,67,9,39,13,6,50,53,40,56,43,37,22,52,36,42,83,55,29,55,48,33,75,60,33,44,37,18,0,2,74,27,48,65,71,50,48,2,20,17,2,45,55,55,60,4,31,15,21,11,76
"2015-11-01",55,2,34,41,43,60,0,11,31,35,58,12,40,46,53,18,13,25,81,9,50,48,65,55,62,54,56,65,2,35,61,51,31,41,22,8,24,43,62,84,37,18,44,60,13,14,16,16,71,50,7,18,4,8,47,18,17,60,36,2,1,8,8,19,0,21,5,62,14,9,37,45,27,35,33,70,56,61,56,46,57,35,15,61,4,63,43,49,41,41,73,45,6,31,27,57,63,4,37,18,6,48,52,42,60,37,35,24,48,29,46,76,53,29,52,40,34,70,52,30,40,27,22,7,3,68,27,42,57,68,39,43,0,18,18,1,42,50,54,60,6,24,13,27,8,62
"2015-12-01",44,0,33,26,32,55,0,14,32,40,54,15,46,42,47,20,7,20,54,8,54,47,69,53,59,51,53,60,1,27,46,49,29,31,17,8,23,33,58,76,32,15,43,49,4,8,20,9,66,40,5,14,4,5,41,12,14,52,27,2,1,4,5,17,0,19,4,52,12,12,31,49,33,36,32,68,64,70,51,54,41,30,15,54,3,53,41,42,42,42,69,39,8,29,25,56,60,4,32,16,5,38,35,36,61,36,30,19,55,29,45,62,38,30,57,47,28,66,50,30,41,31,27,15,5,66,27,37,55,65,37,29,0,23,15,2,37,43,55,50,1,24,9,17,9,62
"2016-01-01",48,3,43,26,27,57,5,13,28,51,55,12,55,50,42,23,9,20,60,10,73,57,75,64,68,52,49,70,1,34,49,48,30,37,16,10,32,39,85,94,35,19,48,54,7,11,17,9,69,57,5,18,2,5,39,12,19,58,27,4,1,4,7,18,0,21,5,54,13,12,33,63,32,44,36,61,66,91,51,51,53,40,16,40,3,77,50,45,47,39,73,50,9,38,26,68,69,10,34,13,5,41,48,39,62,43,28,27,56,30,47,45,32,32,55,61,33,86,65,30,45,38,31,0,3,81,29,34,70,75,55,29,1,28,14,2,38,35,51,65,2,39,12,20,8,66
"2016-02-01",58,0,56,60,41,67,0,14,48,49,67,15,58,54,59,21,10,23,80,14,74,64,79,72,78,57,64,80,4,41,70,57,33,36,18,10,33,44,80,89,46,18,53,71,11,12,21,17,73,57,9,12,2,4,45,38,21,64,45,6,2,4,7,17,1,22,5,61,21,17,35,57,38,45,40,62,68,69,60,61,86,49,25,66,3,64,52,50,53,40,81,54,10,39,33,69,70,7,37,13,6,56,50,38,56,43,38,25,59,35,52,85,59,36,57,67,28,92,52,32,48,41,36,6,4,87,25,47,63,77,45,48,2,31,19,2,43,47,53,60,5,36,9,27,8,77
"2016-03-01",53,2,39,55,52,65,0,14,41,51,65,13,59,54,53,25,10,22,61,13,79,56,76,84,88,59,58,84,2,35,63,54,30,32,19,14,33,43,88,86,37,17,52,61,7,13,21,13,69,58,7,9,5,4,46,29,18,73,43,4,1,1,6,17,0,21,6,60,15,11,35,59,39,48,39,76,73,51,56,55,71,38,20,63,5,65,42,45,51,42,81,54,9,42,34,72,62,14,32,11,6,53,50,38,65,49,42,24,63,31,51,82,58,36,57,66,30,89,95,37,49,43,28,6,4,94,25,46,65,82,45,44,1,19,16,2,38,45,50,63,0,36,5,27,8,93
"2016-04-01",60,2,53,48,45,65,5,18,45,59,64,15,64,52,56,26,13,21,74,12,73,58,73,72,84,57,54,91,2,36,68,51,31,43,20,11,32,44,97,88,41,16,47,65,12,12,22,21,73,63,7,18,4,4,52,27,16,71,45,2,1,7,7,14,0,20,5,62,16,14,37,51,36,52,44,73,82,53,60,52,76,43,17,66,4,71,46,46,54,44,72,53,10,43,38,75,72,7,34,13,5,56,49,42,61,41,32,23,64,31,53,89,60,35,53,66,34,89,87,41,50,43,24,6,4,98,29,51,68,74,50,47,1,24,18,3,41,45,59,62,3,34,7,22,7,92
"2016-05-01",48,1,39,31,28,59,5,19,36,62,74,15,68,48,44,22,9,20,60,11,76,57,78,85,64,53,50,85,0,23,46,47,27,32,15,10,32,34,94,75,31,15,48,54,12,14,18,9,71,70,9,15,5,8,46,22,15,71,33,2,1,8,7,13,1,18,6,52,13,13,35,46,38,40,40,72,75,52,50,43,57,31,12,49,3,70,48,41,46,43,83,50,10,45,29,76,67,13,34,10,5,42,43,48,57,38,27,24,68,28,51,60,41,35,58,64,31,92,78,40,51,45,30,18,1,96,29,39,71,71,48,34,2,29,13,3,35,44,48,59,4,36,6,24,5,85
"2016-06-01",41,1,32,27,27,58,0,25,27,65,72,13,66,45,35,22,9,23,80,7,85,56,82,84,54,53,48,87,0,25,38,48,23,20,11,8,33,29,85,70,27,14,53,45,4,10,15,4,72,62,12,12,1,6,40,10,15,73,23,2,1,1,5,12,0,18,4,49,9,9,27,52,41,39,35,94,83,41,40,39,49,29,4,34,2,70,45,27,37,43,100,47,10,41,21,86,51,8,19,10,4,42,38,35,59,47,24,22,72,25,57,40,32,31,63,67,27,94,80,42,53,52,37,6,3,94,28,31,71,70,49,23,3,25,12,1,34,28,34,62,5,34,8,29,8,94
"2016-07-01",44,0,33,29,26,51,0,27,22,78,84,11,77,45,31,22,6,22,68,9,89,58,84,83,56,48,43,75,1,23,31,42,22,19,11,8,34,30,91,66,25,15,50,41,7,9,10,12,65,64,7,12,2,3,34,10,16,69,23,2,2,4,4,12,1,17,4,46,10,7,24,51,46,38,36,85,93,54,37,34,37,26,9,32,1,73,46,20,38,45,89,42,10,46,23,95,57,11,14,11,4,36,37,34,65,54,19,25,82,23,52,37,25,33,62,63,27,96,84,37,52,58,28,0,2,94,30,23,67,68,47,19,1,19,10,1,30,30,29,63,0,35,8,22,7,100
"2016-08-01",42,1,28,17,20,53,0,22,27,71,81,12,64,44,33,22,6,21,73,8,72,54,75,66,62,51,46,77,1,28,37,45,25,22,11,9,29,31,81,70,23,16,46,43,0,11,11,12,60,52,5,16,3,0,29,10,15,77,21,1,2,1,4,13,0,18,4,48,13,12,32,57,35,34,33,73,65,37,42,36,33,22,4,28,2,66,45,23,40,42,79,46,12,47,20,84,61,3,22,11,5,41,40,38,67,36,20,24,71,19,58,28,27,30,58,63,25,83,81,32,50,35,28,0,2,86,25,25,67,67,49,20,1,19,11,1,33,24,33,61,0,30,5,16,9,99
"2016-09-01",51,1,38,32,39,61,0,12,41,55,57,16,56,50,51,23,8,21,83,7,66,49,72,71,52,53,55,70,1,33,60,47,27,34,18,10,25,42,75,71,34,14,44,64,5,12,20,23,69,50,9,12,3,4,48,5,12,69,35,2,2,9,7,13,0,18,5,54,13,13,32,49,30,36,35,70,76,46,57,43,73,42,41,48,4,62,38,39,45,43,75,50,9,43,30,76,58,3,34,11,5,46,50,35,55,33,29,23,64,27,52,60,43,31,57,59,25,78,74,26,43,29,19,0,3,80,25,36,61,65,40,38,1,24,15,2,40,40,48,56,1,25,6,17,9,76
"2016-10-01",48,1,39,57,35,59,5,7,40,54,69,13,57,51,52,21,10,24,49,9,67,49,74,73,87,52,57,73,2,32,64,49,28,34,15,10,23,42,73,84,38,13,41,59,7,13,17,15,69,57,6,12,6,4,41,10,14,72,43,2,1,4,6,15,0,20,6,58,14,8,33,52,30,39,34,78,73,76,51,53,73,39,24,62,4,57,38,43,43,38,79,50,8,38,25,70,56,6,30,12,6,48,49,33,56,32,41,21,63,30,49,79,56,30,48,52,28,73,80,33,41,29,18,0,2,75,25,39,60,62,41,50,2,22,17,2,39,46,51,56,4,22,16,22,8,76
"2016-11-01",53,1,40,47,40,58,0,7,45,42,55,12,55,52,46,18,11,25,60,8,63,48,71,64,77,51,48,64,1,29,57,47,25,36,17,9,20,40,68,76,39,13,44,53,10,12,15,26,75,54,8,23,1,8,48,24,12,61,34,7,2,9,7,20,1,21,5,59,17,11,32,47,23,45,39,58,60,86,53,55,58,40,24,58,4,58,35,46,42,36,60,49,8,38,27,63,57,7,34,13,5,48,44,27,47,35,25,22,55,27,43,75,51,32,53,49,27,64,61,29,38,25,19,17,3,67,24,38,55,61,37,44,4,31,20,2,43,41,54,49,1,22,8,16,8,69
"2016-12-01",42,1,35,37,30,51,9,13,40,47,64,11,60,45,39,17,10,18,74,9,62,49,72,57,57,47,48,72,1,28,46,44,22,29,13,10,19,33,65,78,40,10,39,46,15,10,16,9,74,52,6,14,1,8,42,16,13,66,34,0,1,4,6,14,0,17,5,49,19,6,25,38,26,42,33,54,62,100,46,45,53,35,4,54,3,56,33,38,40,38,66,44,8,40,26,63,53,11,27,13,4,39,36,28,51,34,23,22,60,28,47,66,44,28,53,54,29,64,61,27,38,26,19,0,4,66,21,31,53,58,32,32,1,27,14,2,35,31,48,47,0,16,8,17,7,52
"2017-01-01",51,1,40,32,22,58,0,14,35,65,61,12,62,55,42,23,13,29,88,9,70,50,76,79,73,54,49,77,1,31,47,52,30,34,15,11,29,36,89,94,33,20,48,56,8,10,13,10,74,56,7,16,2,7,45,7,15,73,26,5,2,8,9,19,0,22,7,58,18,14,35,60,30,43,38,71,69,86,53,45,55,37,18,45,4,65,50,43,50,39,77,51,11,46,30,70,67,13,34,15,7,45,48,34,57,40,26,25,62,28,58,47,36,34,55,71,36,85,68,37,45,40,33,5,3,79,29,33,71,73,44,35,2,24,18,2,45,41,46,61,3,34,13,22,8,67
"2017-02-01",58,0,56,65,48,67,0,13,40,65,70,14,68,57,55,23,13,27,88,11,70,55,74,69,69,59,62,83,2,39,67,57,30,31,21,9,29,41,83,92,41,19,43,70,12,14,16,34,79,59,9,14,2,4,56,14,17,77,42,2,2,6,10,17,0,20,6,60,20,18,36,48,28,50,42,68,65,38,58,60,97,46,35,68,4,57,46,48,52,38,67,54,10,47,30,72,65,22,38,10,6,54,51,33,58,43,33,22,70,36,61,86,66,37,55,72,32,86,55,29,45,33,25,29,5,83,23,42,62,75,40,43,3,25,18,3,41,53,54,55,3,29,7,22,6,79
"2017-03-01",55,4,45,57,46,67,0,13,40,66,77,13,78,52,51,24,17,45,74,11,81,54,77,86,63,59,59,82,2,38,61,55,33,36,20,11,27,41,90,85,41,19,53,64,9,17,19,23,80,64,8,18,3,5,53,21,15,85,38,5,11,14,11,42,1,30,10,62,31,10,37,51,35,52,42,76,65,61,57,60,73,42,28,70,5,69,44,45,53,42,73,55,11,49,27,76,62,15,34,70,27,52,49,36,59,47,40,24,76,36,60,87,60,37,52,77,34,88,90,38,46,38,27,15,2,93,24,44,62,78,38,45,8,25,26,3,50,51,58,58,11,29,8,27,10,84
"2017-04-01",53,1,63,49,52,64,0,11,44,60,71,13,75,51,50,24,14,28,58,12,72,53,75,84,75,54,53,88,2,33,60,52,28,30,16,12,27,43,92,89,39,18,48,65,6,16,24,23,79,66,8,16,4,5,62,14,16,71,44,2,3,10,9,16,0,20,5,66,20,16,37,49,30,50,41,83,70,41,58,69,78,42,45,70,4,61,44,41,52,40,78,53,9,49,35,76,63,15,35,16,8,54,48,33,55,43,33,22,76,35,62,99,61,39,51,72,41,86,85,37,45,37,23,6,5,94,29,46,62,69,44,42,2,23,18,3,43,50,57,59,2,29,9,28,7,91
"2017-05-01",48,5,37,29,25,58,0,11,38,61,83,12,78,47,43,24,15,38,75,9,74,51,75,82,76,72,51,91,2,29,49,50,25,31,16,11,29,34,81,76,31,18,51,55,7,14,19,14,87,74,7,16,2,8,55,14,13,76,36,5,11,10,10,24,2,26,13,52,24,17,34,48,28,45,39,67,72,74,53,51,57,31,35,56,4,63,46,42,48,40,83,51,11,54,27,84,65,15,32,35,16,48,43,30,57,40,33,20,75,36,58,64,37,36,43,73,28,86,99,43,50,45,29,0,5,95,25,35,67,67,46,38,7,24,21,4,42,40,47,57,6,31,5,30,6,82
"2017-06-01",49,2,29,27,24,55,0,16,28,70,93,13,83,44,32,24,10,33,100,7,85,53,85,93,61,62,47,100,1,17,33,48,22,20,11,10,31,31,92,69,28,17,50,43,5,10,11,7,76,70,5,6,2,3,40,10,11,84,19,8,9,6,7,17,1,22,9,51,25,10,27,56,35,44,36,92,96,41,40,32,40,27,8,36,3,67,47,23,41,42,86,49,11,56,21,89,50,10,18,15,16,38,39,38,59,48,25,22,83,34,64,44,30,35,53,87,32,91,94,50,54,51,32,12,2,95,28,29,69,65,46,19,6,25,16,2,38,26,38,60,8,26,4,24,8,90
"2017-07-01",38,4,31,29,23,54,0,16,26,73,90,18,91,43,29,24,10,39,84,7,90,58,85,82,46,53,46,81,2,22,31,45,19,17,9,11,32,29,100,71,22,21,55,38,5,7,11,7,79,72,3,12,3,7,40,19,15,89,22,2,9,6,6,16,2,24,7,48,28,12,23,49,39,43,39,92,89,65,44,37,42,23,16,34,3,75,48,19,36,47,84,46,10,61,18,98,58,11,12,14,23,36,39,36,60,51,23,25,97,36,67,38,29,38,56,76,32,91,95,48,57,60,29,12,3,100,27,23,71,68,45,19,4,11,18,2,40,32,35,59,4,29,4,24,7,93
"2017-08-01",41,1,30,22,22,55,9,15,24,64,89,16,76,45,31,25,8,29,94,8,76,56,79,92,50,57,49,86,2,26,33,48,24,21,13,10,26,31,87,76,28,14,53,42,11,9,9,7,79,68,6,11,2,3,42,9,15,98,17,3,2,5,5,13,1,19,4,49,11,10,35,53,30,39,36,80,77,32,42,35,34,23,4,30,2,65,50,24,41,42,87,49,10,53,19,92,58,5,20,10,7,37,44,36,68,34,23,25,79,36,65,30,23,37,52,80,37,85,91,37,47,42,21,6,1,91,25,27,74,65,49,18,2,18,12,2,34,26,36,59,2,27,6,16,9,83
"2017-09-01",46,2,34,42,39,61,0,11,42,64,83,12,71,50,45,23,10,31,93,11,63,50,69,64,70,51,52,69,2,31,55,49,26,29,13,10,23,39,76,75,35,16,51,65,10,9,18,26,80,64,7,16,2,3,41,16,12,64,27,6,4,8,8,14,0,21,6,56,21,11,31,54,28,42,34,68,71,30,47,51,75,44,11,50,3,63,42,35,46,38,69,53,7,48,27,77,61,1,31,14,11,46,52,33,50,29,31,24,69,39,54,60,45,34,46,59,31,72,90,35,45,36,21,5,1,80,25,38,68,63,43,38,4,28,18,1,41,35,45,58,7,28,6,14,7,55
"2017-10-01",52,1,42,64,45,64,0,15,42,51,68,14,68,52,49,22,11,28,81,12,61,48,70,71,75,57,59,77,1,34,62,53,26,33,19,12,23,44,78,88,41,16,47,60,14,15,17,18,87,62,7,13,1,4,54,13,14,78,38,2,2,4,8,18,2,21,7,60,20,15,34,51,27,47,36,67,59,84,53,65,88,44,25,65,5,61,44,43,47,42,63,55,9,50,33,72,64,9,38,15,10,51,55,34,56,34,29,27,69,42,60,94,57,33,43,66,33,71,75,36,45,30,19,0,3,75,26,44,60,66,38,44,3,17,18,2,43,43,51,56,2,26,11,18,7,74
"2017-11-01",53,2,50,56,53,59,0,9,41,44,65,14,66,49,44,20,11,24,86,11,55,45,69,65,66,54,54,79,2,30,59,55,25,32,13,12,19,40,74,87,39,12,45,57,8,15,17,14,98,61,7,24,1,5,56,29,12,68,37,2,2,6,7,18,1,20,6,58,16,13,32,46,22,46,35,61,57,90,59,72,77,43,30,62,5,61,40,44,47,34,73,47,12,46,33,67,66,7,34,17,6,50,51,30,54,30,30,22,64,39,65,83,62,34,41,64,33,66,47,29,39,27,22,11,1,70,26,41,56,62,33,38,3,14,17,2,42,46,52,50,4,21,14,14,5,49
"2017-12-01",48,2,39,31,31,51,0,10,40,53,71,11,75,45,36,22,7,22,71,10,52,45,69,76,44,48,47,67,1,23,43,44,21,23,12,14,22,29,71,84,29,12,42,45,5,11,18,19,98,64,5,11,1,2,44,16,12,61,31,3,2,7,6,15,2,18,11,51,16,11,27,43,25,44,35,59,60,89,52,63,58,38,15,52,10,52,38,36,39,36,70,38,10,46,27,64,58,5,28,15,5,38,39,28,51,36,26,24,70,41,56,61,43,41,44,62,28,60,57,30,39,31,25,11,3,68,24,29,52,55,33,31,3,25,14,2,37,44,53,49,1,19,10,17,7,53
"2018-01-01",46,0,29,31,32,59,0,10,36,65,72,14,78,51,40,24,8,26,89,10,61,49,70,78,92,58,50,80,2,26,43,50,26,29,14,14,27,34,85,91,33,13,47,51,5,10,15,11,87,57,7,15,2,2,47,8,15,86,31,4,2,4,6,14,0,20,7,54,13,12,36,52,27,49,38,65,65,100,51,45,39,35,14,46,5,76,48,40,43,39,77,46,6,54,26,72,67,9,31,14,7,38,47,37,58,40,26,27,70,44,71,46,30,42,46,87,39,76,57,28,41,42,21,0,3,76,28,34,69,66,41,31,3,31,14,1,40,43,52,64,3,29,7,20,8,63
"2018-02-01",53,1,53,55,39,63,0,11,53,77,81,12,72,52,51,20,12,26,86,13,64,54,71,84,77,59,70,80,2,36,58,58,31,33,18,12,28,35,93,95,40,16,45,65,7,13,21,35,87,64,8,8,0,4,47,14,16,88,35,4,2,10,7,14,1,20,7,60,17,15,36,52,27,57,44,66,72,57,59,61,83,43,46,75,4,66,43,45,47,39,74,49,10,49,31,72,61,7,36,12,6,51,52,26,59,34,35,25,72,54,80,95,57,42,44,82,30,80,75,33,43,42,27,17,5,82,22,39,60,72,35,45,0,28,18,2,44,58,65,61,2,25,5,22,7,68
"2018-03-01",56,1,49,55,48,61,0,15,32,69,78,17,87,49,44,25,10,24,78,12,68,52,73,97,100,65,54,89,2,38,55,53,28,28,18,13,28,37,93,89,37,18,44,58,11,14,17,13,87,68,6,8,3,5,50,21,14,85,36,2,2,6,8,15,1,19,6,59,16,15,36,50,30,52,44,80,91,77,54,59,74,36,31,64,4,64,46,42,49,39,76,46,9,53,24,77,65,11,36,13,5,51,50,35,57,42,31,21,82,41,77,93,54,37,41,81,34,78,90,34,45,34,24,26,2,91,24,39,62,71,33,43,1,34,15,2,41,41,58,55,2,27,9,28,7,73
"2018-04-01",59,1,58,62,46,63,0,10,54,73,84,16,85,51,47,26,11,24,70,12,62,49,70,81,67,63,54,84,2,32,60,53,30,25,15,10,26,39,91,91,37,21,48,61,17,13,20,22,83,75,8,18,2,2,61,20,14,90,46,3,2,6,7,15,0,19,7,59,16,18,36,56,26,55,44,78,73,47,59,62,84,41,29,69,4,67,51,42,44,40,79,49,14,61,35,76,70,14,40,13,5,56,51,32,56,34,31,23,75,39,81,99,66,39,38,85,38,80,86,32,46,39,23,16,2,92,21,42,66,67,42,44,2,34,16,2,42,43,59,61,2,29,8,25,9,72
"2018-05-01",46,1,37,36,29,57,9,9,34,71,94,14,80,45,41,25,8,23,70,12,66,48,71,89,70,60,51,91,2,27,46,53,25,25,15,11,27,32,92,81,31,18,54,51,9,11,20,15,90,72,7,18,2,0,47,24,14,86,32,3,2,4,6,13,1,18,6,53,15,14,34,52,28,48,42,81,80,57,55,46,55,31,32,56,3,67,47,40,47,39,92,45,13,59,27,82,66,6,34,11,5,43,44,34,54,39,30,22,79,34,83,65,43,37,38,81,43,76,80,33,44,40,22,21,2,89,22,37,68,63,37,33,3,26,13,2,36,41,52,61,1,31,8,29,5,77
"2018-06-01",43,1,29,25,30,54,0,13,23,70,99,13,100,44,32,26,7,26,76,9,75,48,77,100,57,57,47,97,1,20,32,48,22,17,9,13,27,25,94,74,24,13,49,45,11,9,12,11,81,76,4,8,2,3,40,18,12,89,25,3,2,5,4,13,1,18,5,49,11,12,26,56,28,47,38,100,100,67,43,38,52,26,0,40,2,70,48,24,40,42,97,42,10,60,23,91,51,11,17,12,5,38,45,34,56,42,27,24,91,31,82,43,33,38,45,86,36,79,83,43,50,45,27,11,3,92,26,25,72,61,40,28,3,27,11,1,34,28,41,66,0,28,4,19,5,86
"2018-07-01",43,0,37,32,27,52,0,22,29,100,100,14,98,41,30,28,8,23,85,8,77,52,80,90,54,54,46,90,1,19,31,45,20,15,11,13,27,26,93,81,24,14,52,40,3,7,10,7,85,74,4,5,1,3,43,16,13,100,21,3,1,2,5,13,0,18,5,46,11,11,25,52,34,46,39,96,94,53,43,40,43,25,11,40,2,79,54,20,41,38,78,40,13,62,21,100,52,12,12,9,4,37,43,38,56,40,18,23,100,31,84,43,31,37,46,93,41,82,86,37,50,53,30,0,2,95,21,24,72,63,39,30,1,25,12,1,34,39,43,67,1,26,6,26,7,91
"2018-08-01",47,1,27,22,22,55,0,18,23,76,98,17,81,43,31,26,5,22,81,10,67,50,72,95,44,59,48,94,1,24,31,47,23,17,14,12,25,30,90,77,20,14,47,45,3,7,11,12,80,68,4,10,3,5,36,9,14,97,20,2,1,7,4,14,0,18,5,47,12,12,32,58,24,42,46,88,71,52,47,39,37,27,7,44,2,75,48,23,40,39,84,41,13,58,20,95,59,6,21,11,5,36,46,36,59,33,26,23,82,30,88,33,25,36,41,83,46,75,100,29,43,37,24,0,1,92,26,25,71,64,39,24,2,16,12,1,35,45,51,66,1,25,5,29,7,81
"2018-09-01",46,0,46,35,42,61,0,9,48,64,83,13,79,50,45,22,12,23,79,11,55,45,65,66,61,56,56,85,0,30,56,48,24,28,15,13,22,36,86,85,34,14,46,67,11,10,13,15,85,64,6,8,2,6,49,16,13,79,32,3,1,6,9,15,0,19,6,55,19,16,33,62,20,44,38,96,75,57,58,56,89,42,18,59,2,59,45,36,46,36,76,45,14,57,29,81,60,5,34,10,5,43,57,29,46,30,30,19,78,33,81,64,56,36,35,73,40,66,73,29,40,27,20,0,2,81,20,37,65,61,35,43,3,22,17,1,40,53,55,58,5,26,8,15,7,66
"2018-10-01",51,1,46,62,47,62,0,8,44,50,79,12,72,50,48,27,11,24,71,13,50,41,63,71,58,60,63,81,2,29,60,58,29,29,16,13,18,40,83,88,40,16,43,58,5,12,21,25,100,69,7,10,0,2,52,28,13,83,45,3,2,10,7,16,0,20,6,61,17,14,32,56,19,55,42,75,82,77,63,56,83,43,21,76,3,59,42,45,46,36,71,47,6,53,33,76,63,11,39,13,6,47,51,33,50,24,29,23,70,42,71,100,70,33,32,70,33,61,82,25,36,26,19,21,6,76,25,42,64,62,32,50,1,18,17,2,43,51,60,55,2,21,6,19,6,56
"2018-11-01",56,1,44,53,36,56,0,9,42,56,67,10,77,47,41,23,11,23,68,12,47,43,64,69,91,55,51,79,1,27,55,49,22,31,17,12,18,34,74,84,34,13,36,51,6,11,16,13,98,63,6,21,1,12,53,9,13,83,34,3,1,5,7,16,0,19,5,57,16,12,29,48,19,48,43,66,70,99,63,51,62,36,33,63,3,61,38,45,46,37,78,43,9,49,30,67,51,8,33,12,5,46,45,29,47,28,30,22,64,35,80,84,63,31,37,65,31,57,75,25,34,28,18,21,3,68,21,35,58,58,30,43,2,26,17,1,42,51,54,49,3,21,3,14,7,53
"2018-12-01",49,2,29,36,29,48,0,8,40,57,70,12,82,41,33,22,7,20,78,9,48,42,64,65,64,47,45,68,2,22,39,43,20,21,12,10,17,27,77,80,27,13,31,42,13,10,13,12,98,62,5,13,2,4,48,20,11,70,28,4,1,6,4,13,0,16,6,46,13,7,24,48,22,45,37,66,61,70,50,47,55,30,15,58,3,59,35,37,36,31,73,35,7,45,27,65,54,13,27,11,4,36,35,30,45,30,22,23,74,31,83,64,44,29,35,66,35,53,61,25,33,25,17,11,2,66,21,27,54,54,25,30,2,28,13,1,33,41,57,48,3,17,3,18,9,51
"2019-01-01",54,0,37,31,28,58,4,9,34,77,77,13,76,53,40,26,9,22,63,12,56,45,65,86,79,59,52,81,2,27,43,51,27,26,17,14,22,33,99,96,31,14,41,55,3,11,17,8,85,64,7,20,1,2,49,13,13,88,28,6,2,2,6,14,0,20,6,55,12,10,33,57,17,46,40,75,70,89,58,55,60,42,21,53,2,70,46,41,47,36,76,44,9,53,26,73,66,10,34,12,5,39,46,31,55,37,28,21,71,32,100,49,41,31,33,100,38,66,56,27,36,33,16,0,3,77,24,30,71,64,36,30,2,24,14,1,41,43,55,64,2,28,8,26,9,58
"2019-02-01",55,3,49,54,46,65,0,6,45,73,82,14,86,54,48,24,10,20,97,13,53,48,64,83,79,57,61,95,1,30,58,52,28,27,17,13,19,36,98,100,36,16,40,66,14,13,20,31,83,70,9,14,3,13,54,14,16,95,38,6,2,6,7,13,0,19,5,57,18,13,33,59,17,51,43,75,56,53,59,63,100,46,52,74,2,67,45,44,45,35,63,47,10,48,34,73,62,10,35,13,4,49,47,28,58,26,34,23,74,32,97,86,67,33,32,94,42,66,68,25,37,29,22,14,2,81,22,35,63,67,32,45,7,27,16,2,44,53,57,60,1,28,6,36,7,65
